width 20
height 20
.@@.@......@..@....@
.@...@.@@@@.@...@.@@
.@@@..........@@@.@@
...@@@.@@.@.@@@@@..@
.@.@.@@.@.@@@.@@@.@.
@@........@@..@.....
...@.@.@.@@.@...@.@.
.@.@@@@.@...@@.@..@@
.@@..@....@...@@@..@
@.@.@.@.@..@@..@.@..
@........@.@.@.....@
@@@.@.@.@.@...@.@@..
@....@.....@.@@@@@@@
@.@.@.@@.@......@...
@@@@....@..@.@.@.@.@
@@@@@.@.@@@@.@......
@@@@@@........@.@.@@
@@@@@@@@.@.@.@@@@@@@
@@@@@@.@.@..@@@@@@@@
@@@@@....@.@@@@@@@@@
1
5 9 0

11 3 0
