width 20
height 20
@@@@....@.@@@@@@@@@@
@.@.@.@...@@@@@@@@@@
@.....@@@.@@@@.@@@@@
@@.@.@....@@@...@@@@
@@..@.@.@..@.@@.@@@@
@@.@....@@@.......@.
@@@..@.@...@@.@.@...
@@@.@....@...@...@.@
@@.@..@@@.@.@@@.@.@@
@...@.....@@@@....@.
..@@@@@@@..@@@@.@...
@...@@.@..@@@@.@.@@.
..@@.....@@@@@......
@.@.@@.@@.@@@.@.@.@.
...........@...@@..@
.@@.@.@.@.@.@.@@.@.@
...@..@@............
.@@.@..@.@.@.@@@.@.@
..@...@...@.@.@.@...
.@..@.@@.@........@.
1
8 1 0

4 12 0
