width 20
height 20
....................
....................
..........@.....@...
..@......@........@.
......@.............
....................
.............@.@....
....................
.......@..........@.
...........@....@...
............@.......
...@@........@......
..............@.....
@.......@...........
...........@........
..@.....@.....@.....
...........@.....@..
....@.@.........@...
@..............@....
....................
13
0 15 0
8 16 0
17 18 0
8 4 0
19 9 0
8 9 0
14 9 0
15 17 0
5 17 0
16 15 0
17 1 0
16 10 0
17 14 0

13 4 0
11 11 0
14 18 0
17 12 0
15 12 0
1 0 0
15 4 0
1 2 0
3 8 0
0 1 0
8 6 0
0 6 0
8 5 0
