width 20
height 20
..............@@....
.............@......
...............@....
..................@@
....@...............
........@.......@...
.......@............
...@.........@......
....@....@.....@....
....................
....@..@....@....@..
..................@.
.........@..........
..@.@...............
............@.@.....
.............@......
......@...........@@
....................
....................
@@..................
13
9 18 0
1 4 0
4 5 0
13 4 0
14 2 0
5 13 0
1 10 0
13 10 0
7 16 0
4 2 0
6 12 0
4 1 0
8 17 0

11 8 0
1 5 0
16 0 0
2 17 0
16 15 0
16 17 0
15 1 0
1 0 0
19 11 0
17 19 0
6 13 0
5 7 0
7 14 0
