width 20
height 20
........@@.@........
.@..................
....................
......@..@..........
..@.............@...
..........@.......@.
....................
...........@........
....@.@..@.....@....
..@.................
......@...@.........
...........@..@..@..
.......@.....@......
........@.@.........
...@................
.......@....@.......
........@....@.@....
.....@..............
...................@
@..@................
13
12 7 0
16 16 0
11 4 0
12 14 0
4 13 0
3 2 0
8 8 0
3 1 0
2 19 0
17 5 0
18 16 0
18 17 0
17 15 0

10 19 0
0 5 0
11 5 0
6 12 0
4 13 0
4 1 0
8 8 0
13 9 0
7 11 0
18 7 0
0 0 0
7 17 0
17 10 0
