width 20
height 20
...................@
.....@.......@......
..@....@............
....................
.........@......@...
......@.@........@..
............@.@.....
..........@.........
...@@@...........@@.
..........@......@..
...@..@....@.....@..
...................@
..............@.....
.................@..
..@...@........@....
.................@..
...............@....
@...................
@@................@@
@@................@@
13
7 8 0
12 19 0
2 1 0
18 17 0
17 0 0
4 15 0
12 15 0
10 6 0
0 4 0
18 1 0
19 3 0
16 18 0
12 9 0

4 9 0
16 0 0
4 18 0
7 5 0
13 8 0
14 1 0
11 18 0
13 17 0
0 6 0
14 4 0
4 16 0
4 5 0
4 11 0
