width 20
height 20
....................
@.......@...........
@..@................
.............@......
.....@..........@..@
@..........@.....@.@
@.....@............@
....................
...@................
........@....@......
.................@..
....@.@.............
........@..@.....@..
..........@...@.@...
@...................
....................
......@....@.....@..
.......@...@.@..@...
...@.@..............
.............@@.....
13
2 13 0
6 14 0
11 9 0
19 11 0
1 18 0
14 4 0
15 14 0
12 6 0
7 0 0
17 4 0
10 8 0
1 14 0
4 12 0

3 13 0
19 0 0
9 15 0
19 16 0
2 12 0
1 16 0
9 0 0
12 0 0
14 10 0
6 18 0
0 19 0
15 3 0
0 13 0
