width 20
height 20
.....@..............
......@@............
....................
.@..................
...@..@.............
....@....@@......@..
.............@......
.......@............
...........@..@...@.
..........@.........
....@...@...........
.@.........@........
.............@....@.
....................
......@.............
.@@.......@......@..
@@@.................
@@@...............@.
@@....@.....@...@...
@@@@................
3
0 12 0
8 16 1
1 14 2

16 11 0
0 13 1
2 10 2
