width 20
height 20
....................
...@.............@..
......@...@.........
.@.......@...@.@....
@..@........@.......
....................
.................@..
.......@.......@....
...@..........@.....
........@...@.......
....................
....@...............
.............@......
.........@..........
........@....@......
..................@.
.@..................
.......@........@...
....................
....@...............
3
19 4 0
7 2 1
11 8 2

7 19 0
12 13 1
3 18 2
