width 20
height 20
@.....@@@...........
......@@.....@......
...@................
.............@......
...@....@...........
..............@.....
...............@....
.....@..............
....@...@.......@...
.........@..........
..@............@..@.
....................
....@@.....@........
.@...@..............
...................@
.........@..@..@...@
......@...@.....@..@
...@............@@..
....................
.....@..............
3
11 9 0
13 0 1
17 2 2

8 10 0
16 19 1
14 6 2
