width 20
height 20
....................
..........@....@....
.................@.@
........@..@........
....................
@..@................
.......@............
..............@.....
.........@..........
............@@......
..@.@...............
........@...........
..........@....@....
..................@@
@..@.@@.........@.@@
....@...@..........@
...@...@............
.@......@.@...@.....
...@............@...
............@......@
3
6 2 0
13 0 1
14 5 2

14 5 0
5 17 1
1 18 2
