width 20
height 20
.........@@.......@@
.....@...@@........@
..@...@........@....
....@............@..
.........@..........
.@.@......@..@......
...............@..@.
......@..@.@........
@...........@.@.....
.....@..............
............@.......
.........@..........
@...................
@.....@....@........
@............@......
@...@.........@...@.
...............@....
......@.....@...@...
....................
......@@............
3
17 5 0
0 11 1
8 2 2

12 5 0
18 17 1
15 5 2
