width 20
height 20
............@@@@....
.......@............
....................
........@...........
...@..........@.....
......@.....@....@..
..........@.........
.......@............
................@...
.......@..@...@.....
..@.................
@..........@.@..@...
@...@............@..
...@.@.@...@........
..@...@........@..@.
....@...............
....................
.@..................
.................@..
@.............@@....
13
17 17 0
1 18 0
6 17 0
0 16 0
3 16 0
19 11 1
2 3 1
4 1 1
9 8 1
8 0 2
4 10 2
10 11 2
8 9 2

17 11 0
2 18 0
17 9 0
18 0 0
9 14 0
9 1 1
16 18 1
5 10 1
18 8 1
16 15 2
18 1 2
19 5 2
3 3 2
