width 20
height 20
............@@@@....
.........@@.........
......@@..@@@.......
..........@@@...@...
............@..@....
....@...@...........
..@.................
...@....@...........
......@.............
.......@.@....@..@..
.................@..
.....@.........@....
.......@......@.....
........@...........
..............@.....
..@.........@.......
....................
..........@.......@.
...@@@......@..@....
.@@@@@....@.........
13
11 18 0
14 1 0
6 7 0
7 16 0
5 4 0
18 14 1
11 13 1
13 15 1
6 18 1
10 10 2
16 11 2
4 12 2
15 10 2

1 4 0
18 2 0
6 7 0
0 8 0
15 19 0
9 6 1
10 6 1
11 11 1
13 7 1
13 17 2
2 11 2
7 11 2
16 6 2
