width 20
height 20
....................
............@..@....
....@......@........
..@.................
...............@....
.........@......@@..
.....@..@...........
...@.......@...@....
..........@.........
....................
@..@......@@.@..@...
....................
....................
..@....@.......@.@..
...@.....@.@..@.....
......@.............
................@...
.....@..............
....@@....@.....@...
............@..@@...
15
17 1 0
19 2 0
16 9 0
3 4 0
2 16 0
18 17 0
5 15 0
5 13 0
7 16 0
17 9 0
6 7 0
9 2 0
10 2 0
18 12 0
2 4 0

9 15 0
4 9 0
0 11 0
16 1 0
4 19 0
18 18 0
13 9 0
5 13 0
4 6 0
6 17 0
19 18 0
7 10 0
12 13 0
1 0 0
15 3 0
