width 20
height 20
..................@@
..@.................
......@....@.......@
....................
....................
@..@......@.........
@.@...............@.
@.......@.....@.@...
@@..........@......@
@@......@...........
@@....@@.@....@.....
...@.@.........@.@..
..................@.
.......@......@.....
.........@.....@....
..@..........@......
..........@......@@.
..............@.@@..
.........@..........
...@..........@.....
15
3 17 0
0 2 0
5 2 0
0 0 0
9 8 0
15 6 0
15 19 0
6 3 0
8 18 0
9 9 0
4 13 0
7 14 0
16 18 0
1 2 0
16 16 0

17 0 0
16 13 0
9 11 0
12 16 0
0 0 0
4 16 0
10 18 0
19 19 0
13 17 0
4 7 0
8 10 0
17 7 0
0 3 0
2 10 0
2 16 0
