width 20
height 20
....@..............@
...@.........@.....@
...................@
...........@........
...........@@.......
................@...
.....@............@.
......@.............
....................
......@.............
........@@...@......
......@@@@.......@..
..@....@@.@...@.@...
@...........@.......
@..@........@...@..@
@....@.............@
@..................@
..@.....@.......@.@@
............@.......
......@.............
15
6 0 0
7 10 0
17 12 0
4 7 0
8 3 0
17 6 0
19 4 0
17 2 0
4 5 0
3 19 0
5 0 0
10 17 0
1 1 0
4 2 0
13 5 0

11 7 0
17 12 0
17 18 0
19 19 0
9 3 0
2 14 0
3 18 0
2 18 0
2 7 0
3 12 0
16 19 0
10 17 0
4 8 0
6 12 0
3 11 0
