width 20
height 20
@@@@@..@.@@.@@......
@@@...@........@.@@@
@@@.@..@@.@@.@.@....
@@@@.@.....@@@@..@@@
@@@....@.@@@.@..@.@@
@@..@@@@@@@..@@.....
@.@....@.@@@.@@@@.@.
....@@.@..@....@@@..
.@.@@@..@...@.@@@@@.
@.@@@@.@@@.@.@...@@.
..@@...@@.....@@....
@...@@...@@.@....@@.
@@.@...@...@@@@.@@..
@....@@..@.@.@@..@.@
@@.@...@@..@..@.@@..
@@..@.@@@@...@.@@@@@
@@@..@@@@@@@...@@@@@
@@..@@@@@@@..@@@@@@@
@@@..@@@@@@@@@@@@@@@
@@@@..@@@@@@@@@@@@@@
14
11 5 0
3 16 0
3 18 0
3 5 0
9 10 0
2 14 0
11 10 0
16 0 0
10 9 0
17 5 0
16 2 0
10 12 0
8 11 0
6 8 0

16 2 0
17 5 0
8 1 0
6 2 0
9 7 0
19 6 0
16 1 0
10 3 0
14 11 0
5 15 0
6 11 0
19 11 0
7 11 0
7 1 0
