width 20
height 20
@@@@@....@@@@@@@@@@@
@@@@@@.@..@.@@@@@@@@
@@@@@.@..@....@@@@@@
@@@.@..@.@.@@@@@@@@@
@@..@@......@@@@@@@@
@.@....@.@.@...@@@@@
...@@.@@@....@@@@@@.
@@.@@..@@@@.@@.@....
.....@..@.@@@....@.@
@@.@.@.@......@@..@@
@@@......@.@.@...@@@
@@@@.@.@@@..@.@.@@@@
@@@@@@...@.@....@@@@
@@@@...@@..@.@.@@@@@
@@@@@.@@@@.@@..@@@@@
@@@@@@@@@@...@@@@@@@
@@@@@@@@@@@.@@@@@@@@
@@@@@@@@@@@.@@@@@@@@
@@@@@@@@@@@@@@@@@@@@
@@@@@@@@@@@@@@@@@@@@
12
6 3 0
14 10 0
6 9 0
6 8 0
7 12 1
6 4 1
9 9 1
2 9 1
10 3 2
12 10 2
0 8 2
1 6 2

8 3 0
5 6 0
1 8 0
10 6 0
5 13 1
8 4 1
12 5 1
10 9 1
7 10 2
8 9 2
14 8 2
13 9 2
