width 20
height 20
@@@@@@@...@@@@@@@@@@
@@@@@...@.@@@@@@@@@@
@@@@@.@@.@.@@@@@@@@@
@@...........@@@.@@@
@@@@@@.@.@.@@..@..@@
@@.@.@..@@.@.@...@@@
@......@@......@@@@@
..@@@.@@@@.@@@...@@@
@...@...@@@@...@@@@@
@.@.@.@.@...@.@@@@@@
@@@.@@@@@@@.@......@
@@@....@@@@..@.@@@..
@@@.@.@@@@@@.@@@@..@
@@.@@..@@@@@...@.@..
.....@.......@@....@
.@.@.@.@.@@@@.@.@@.@
.@..@.@.@@@......@.@
.@.@.....@.@.@@.@...
@@...@.@....@.@@.@@.
@@@@@..@@.@.........
12
3 11 0
5 16 0
11 3 0
18 11 0
12 3 1
9 6 1
6 4 1
0 15 1
14 8 2
10 4 2
10 2 2
3 12 2

16 18 0
8 4 0
14 19 0
18 12 0
2 18 1
9 3 1
6 6 1
18 15 1
6 3 2
4 18 2
13 18 2
12 6 2
