width 20
height 20
.@@.@@@@.@..@@@@.@.@
.....@@@...@.@@.....
@.@.@.@.@@...@@.@@.@
...@@....@.@@...@...
.@@@.@@@.@.@@@@@@@@.
..@..@......@....@@.
.@.@...@@.@.@.@.@@..
....@.@@@..@@..@@.@.
.@@...@@@@.@.@.@@...
@..@@..@@@@....@..@.
..@.@.@.@@..@@.@.@.@
.@.........@@.......
...@.@.@.@..@@.@.@@.
@.@@@@.@..@@@@@@@...
@@@@@@.@@...@@@@.@@.
@@@@@@@@@@@@.@@..@..
@@@@@@@@@@.@.@.@..@.
@@@@@@@@@@.@.....@..
@@@@@@@@@....@.@...@
@@@@@@@@@@.@@@@@@@..
12
6 5 0
9 1 0
5 11 0
13 17 0
19 11 1
10 3 1
0 6 1
3 11 1
19 12 2
10 2 2
18 0 2
4 4 2

17 3 0
18 15 0
4 11 0
14 9 0
19 14 1
18 17 1
5 10 1
12 16 1
15 1 2
0 5 2
17 9 2
13 6 2
