width 20
height 20
@@@@@@@@@@@@...@@.@@
@@@@@@@@@@@@@@....@@
@@@@@@.@@@@@@@@.@@.@
@@@@@...@...@.......
@@.@.@.@.@.@.@@@@@.@
@@.......@...@.@.@..
...@@.@@.@.@.......@
@.@.@@.....@.@@.@@..
.....@@@@.@@@@.@.@@.
.@@@.@@.....@.......
@..@.@@.@@.@@@@.@.@.
@@....@.@@@@@..@.@..
@@.@@@@@.@.@.@...@@.
@....@@@...@.@.@@@@.
..@.@.@@.@.@.@.@.@..
.@.......@.@.......@
@..@@.@.@@..@@.@.@.@
.@.@@..@...@@@@..@..
...@.@@@.@.@@@@@.@.@
.@@.......@@@@@@@...
12
0 14 0
3 14 0
6 19 0
3 19 0
14 15 1
7 19 1
16 5 1
2 12 1
5 5 2
14 1 2
18 15 2
2 16 2

14 3 0
3 7 0
18 19 0
1 8 0
10 17 1
18 7 1
1 13 1
10 18 1
5 5 2
4 18 2
16 8 2
18 6 2
