width 20
height 20
@@.@.@@.@.@.@.@@.@.@
.................@..
.@.@.@.@.@@@.@.@.@.@
.@@...@.@@.@@..@@...
@@@@@.......@@@@@.@@
@@@@@@@.@.@.@..@...@
@@@@@@@..@@.@.@.@.@@
@@@@@@@@.@......@...
@@@@@@@@@@@.@@@...@@
@@@@@@@@@@.@@..@.@@@
@@@@@@@@@...@@......
@@@@@@@.@@.@.@@.@.@.
@@@@@@..........@.@@
@@@@@@@.@@@@.@.@@@@@
@@@@@@@@@@@@@@@@@@@@
@@@@@@@@@@@@@@@@@@@@
@@@@@@@@@@@@@@@@@@@@
@@@@@@@@@@@@@@@@@@@@
@@@@@@@@@@@@@@@@@@@@
@@@@@@@@@@@@@@@@@@@@
12
18 7 0
10 1 0
17 3 0
4 3 0
8 2 1
6 2 1
14 5 1
10 3 1
13 5 2
16 10 2
6 1 2
4 2 2

7 6 0
8 12 0
12 13 0
10 9 0
5 1 1
0 2 1
13 6 1
13 9 1
10 12 2
13 5 2
16 5 2
6 1 2
