width 20
height 20
@@.@..@@@@.@.@@@@@@@
@....@.@......@@@@@@
.@.@.....@.@@.....@@
....@@.@.@.@.@.@@..@
.@.@.@@@@@@...@..@..
..@@.@.@.@.@.@@.@..@
.@@@.@...........@..
.......@.@.@.@.@.@.@
.@.@.@@@@...@...@@..
..@@@.@@@@@..@.@.@.@
.@.@...@@..@.@@.....
@....@@.@.@....@.@.@
@@@@........@.@...@.
@@@@@.@.@.@..@@@.@..
@.@...@@...@.@@....@
...@.@..@.@..@@@@@..
@@..@.@....@@.@.@..@
@@@.....@@@.@...@@..
.@@.@.@.@@....@..@.@
.....@....@@@..@....
9
14 7 0
5 17 0
1 19 0
13 6 0
14 8 0
3 18 0
7 11 0
8 14 0
14 17 0

11 17 0
8 2 0
3 19 0
5 13 0
14 17 0
0 5 0
18 7 0
12 18 0
4 0 0
