width 20
height 20
.@.@.@@@@@..@.@.@@.@
.......@@.@......@.@
@@.@.@......@.@.@...
....@..@.@@.@..@@@.@
@.@@.@@.@.@@.@@.@...
.................@@.
@.@.@.@@.@.@.@.@.@..
@.@@.@...@..@@.@..@.
@@....@.@.@@....@...
...@@@......@.@@..@.
@@..@.@.@@.@@...@..@
@@.@..@@@..@.@.@..@.
...@.@...@.@..@.@.@.
@@.@...@@@.@@...@...
.....@..@.....@.@@.@
.@.@@..@@@.@@.@..@@.
@@...@..@@@@@@..@.@.
@@@@@..@.@.@@.@.....
@@@@@@..........@.@@
@@@@@@@.@.@@@@.@....
6
10 0 0
18 0 0
15 1 0
19 11 0
15 12 0
9 19 0

14 6 0
5 10 0
7 4 0
19 13 0
15 4 0
9 19 0
