width 20
height 20
.@.@.@@@.@@..@@.@...
.@.........@.@..@@.@
...@.@@.@@...@@..@..
@.@@@@@@@@.@..@@..@.
.....@@@@@.@@@@@@...
@.@.@@@@@@...@@@..@@
@@...@@@...@.@@.@...
.@@@..@@.@.@......@.
.....@@...@..@.@@@@@
.@.@.@@@.@@@..@@@@@@
.@@@@...@.@@@@@@@@@@
...@..@@..@@@@@@@@@@
@@.@.@@.@..@@@@@@@..
..........@@@@@@@.@.
@@.@@@@.@@@.@@@.....
@@@.@..........@.@.@
@@@..@@@@.@.@@...@@@
@@@@.......@..@.@.@@
@@@@@@@.@.@@@.......
@@@@@@..@@@@..@.@@.@
13
9 17 0
16 14 0
12 8 0
8 1 0
12 6 0
4 6 1
1 11 1
6 13 1
8 6 1
15 6 2
13 18 2
10 17 2
2 9 2

19 12 0
10 15 0
3 8 0
10 6 0
9 8 0
4 6 1
16 7 1
7 1 1
16 15 1
9 15 2
12 6 2
19 2 2
15 0 2
