width 20
height 20
@@@@@@@@.@@@@@@@@@@@
.@@@...@....@@..@@@@
..@@.@...@.@@.@.@@@@
.@.@..@.@@@......@@@
.....@@@@@@.@.@.@@@@
@@.@.@@@@@@@...@@@@@
@.@@..@@@@@@@.@@@@@@
.....@@@@@@@..@@@@@@
.@.@.@@@@@@..@@@@@@@
..@@..@@@@.@.@@@@@@@
.@@..@@.......@@.@@@
..@.@@.@@@.@.@.@....
.@@....@@..@.....@@@
...@.@..@.@..@.@.@.@
.@..@.@...@.@.@@....
..@@....@.@@..@..@.@
.@@@@.@@....@..@..@@
...@@.@..@.@.@..@..@
.@...@@.@.....@...@@
@..@...@@@.@.@..@.@@
13
10 1 0
2 18 0
0 18 0
3 18 0
0 16 0
15 17 1
11 18 1
16 13 1
16 14 1
9 1 2
0 12 2
14 17 2
9 15 2

2 18 0
13 15 0
0 14 0
11 4 0
5 6 0
18 15 1
19 11 1
13 2 1
4 18 1
2 3 2
1 6 2
10 12 2
3 18 2
