width 20
height 20
.................@@@
@..............@.@@@
.........@..@.......
...@.@.@......@.....
................@...
...........@.@......
....................
@...@.....@..@......
@......@............
@................@..
................@.@.
...........@........
....@.....@.........
..............@.....
@@@@...@............
@.....@....@..@@....
............@.......
....................
............@.......
@@..................
7
17 19 0
10 6 0
18 19 0
1 8 0
6 18 0
19 15 0
5 10 0

17 15 0
4 10 0
1 0 0
1 6 0
13 15 0
4 17 0
9 12 0
