width 20
height 20
..................@.
.....@..............
....@.........@.....
..........@..@.@....
....@..@............
..........@.@...@...
..@............@....
....................
...@................
..........@.@..@..@.
....................
.@..@......@........
................@...
.............@.@.@..
.....@.@..@.........
...............@....
....@.@.............
..........@......@..
....................
....................
7
7 16 0
10 10 0
5 13 0
7 3 0
4 19 0
0 0 0
19 17 0

6 8 0
11 15 0
13 5 0
4 5 0
6 9 0
19 15 0
6 2 0
