width 20
height 20
.................@@@
.............@.@.@@@
............@.......
.........@..........
..@...@.............
.........@...@.@.@..
..........@.@.......
.......@............
.....@..........@...
@......@..........@.
@.....@@..@........@
................@...
....................
......@.@..@...@....
.........@......@..@
@...................
.............@......
....................
....@...@.........@@
..................@@
7
4 10 0
12 8 0
14 16 0
3 2 0
8 9 0
16 10 0
3 17 0

18 10 0
14 10 0
4 2 0
11 2 0
17 19 0
10 2 0
8 16 0
