width 20
height 20
@................@@.
@...................
..@......@..........
................@...
....@......@........
.....@.......@......
....................
.......@............
......@..@.@....@...
...@...........@....
....................
....................
...........@........
..@......@........@.
.......@............
............@..@....
.@..@...............
.......@......@.....
..........@.........
.........@@@........
7
4 12 0
7 18 0
17 10 0
2 15 0
16 5 0
19 0 0
3 11 0

5 13 0
17 16 0
5 16 0
15 17 0
0 18 0
18 19 0
8 8 0
