width 20
height 20
@@@.........@.@@.@..
@@..................
...@.@..............
............@.......
....@......@........
.........@..........
.......@.....@......
............@.......
..@..@..............
.................@..
.@......@.@.........
....................
....@........@@.@.@.
....................
..@....@..@.........
...@@...@.......@...
....................
.@.....@...@........
....................
..................@.
1
1 5 0

18 10 0
