width 20
height 20
.........@..........
....................
....@@..............
..............@.....
.......@........@...
...@....@.....@....@
.....@.....@........
....................
....@.@..@.....@....
@@...........@......
..@...........@.....
..........@.........
.........@.@.@......
..@.................
................@...
.....@...@..@.......
@.............@..@..
@......@.@......@...
....................
......@.............
1
18 8 0

5 1 0
