width 20
height 20
.@@..........@@.....
....................
..@.........@.......
...@............@...
........@....@....@.
...@................
....@.........@.....
..........@.........
.@...............@..
...@...............@
@....@...@..@.......
.@..................
..@........@........
...@..@.@.@....@..@.
.......@.....@......
.@.........@........
..@.......@..@..@...
.......@@...........
.....@@@@...........
....@@@@............
1
14 2 0

12 6 0
