width 20
height 20
@@@@@@@@@@@@@@@@@@@@
@@@@@@@@@@@@@@@@@@@@
@@@@@@@@@@@@@@@@@@@@
@@@@@@@@@@@@@@@@@@@@
@@@@@@@@@@@@@@@@@@@@
@@@@@@@@@@.@@@@@@@@@
@@@@@@@@.....@@@@@@@
@@@@@@@@@.@.@.@@@@..
.@.@@@@@@@.....@.@.@
....@@@@@.@.@.@.....
.@.@@@@@...@..@@.@.@
.@@@@@@@@@..@.@..@.@
....@@@@@.@...@.@...
.@@@@@@@....@@.@@@.@
.....@@@@.@@........
.@@.@.@.@.@.@@.@.@@@
.@.@............@@@@
.....@.@.@.@@@.@.@@@
.@.@..@...@@@@......
..@@.@@@.@@@@@@@.@.@
3
10 8 0
19 18 1
0 12 2

18 14 0
1 14 1
17 12 2
