width 20
height 20
.@@.@..@@@..@...@@.@
.....@..@@@..@.@.@.@
.@.@.@@.@..@........
.@@.@.....@@.@@.@@@.
......@.@.@...@@..@.
.@@.@..@....@@@@@...
.@@@@.@.@@.@@.....@.
@.@@....@.@@..@.@@..
@....@@...@.@@.@@@@.
@@.@.@..@.........@@
@...@@@.@.@.@@.@@...
@@.@@.@.@@..@...@.@@
......@@.@@.@@@@@@@@
.@.@.@....@.@@@@@@@@
@@@....@.@..@@@@@@@@
@@.@@.@@.@.@@@@@@@@@
@....@....@@@@@@@@@@
..@@...@.@@@@@@@@@@@
@..@@.@@@@@@@@@@@@@@
@.@@@@@@@@@@@@@@@@@@
16
12 9 0
19 6 0
0 1 0
13 0 0
19 10 0
2 13 0
5 18 1
11 14 1
5 11 1
12 7 1
16 6 1
18 2 2
2 10 2
2 15 2
2 8 2
14 10 2

17 10 0
6 16 0
17 4 0
11 12 0
14 2 0
6 9 0
7 16 1
14 11 1
12 7 1
19 6 1
8 15 1
11 14 2
4 4 2
1 19 2
5 0 2
3 16 2
