width 20
height 20
@..@@@@@@@@@@@@@@@@@
.@.@@@@@@@@@@@@@@@@@
.@.@@.@@@@@@@@@@@@@@
.......@@@@@@@@@@@@@
.@.@.@.@@@@@@@@@@@@@
@@@..@..@@@@@@@@@@@@
@@.@..@..@@@@@@@@@@@
@....@@.@@@.@.@@@@@@
.@.@@@@@@@.....@@@@@
...@.@@.@..@.@..@@@@
@@.......@@@..@@@@@@
...@.@.@.@@@.@@@@@@@
.@..@..@@.@....@@@@@
..@@.@......@@.@@@@@
@@@@...@.@.@@@@@.@@@
...@.@..@..@@@.@.@@@
.@...@.@@@........@@
..@.@@@@@@@.@@@.@...
.@@@@@@@@@@..@@@..@@
...@@@@@@@@.@@@@@...
16
0 18 0
5 12 0
4 7 0
12 18 0
11 13 0
16 18 0
19 19 1
12 16 1
11 19 1
6 10 1
4 11 1
2 15 2
3 3 2
6 11 2
1 3 2
13 8 2

9 15 0
2 3 0
6 14 0
3 10 0
10 9 0
2 9 0
12 16 1
7 15 1
0 1 1
6 13 1
1 13 1
0 17 2
7 13 2
6 11 2
2 0 2
16 15 2
