width 20
height 20
@@@@@@@@@@@@@@@@@@@@
@@@@@@@@@@@@@@@@@@@@
@@@@@@@@@@@@@@@@@@@@
@@@@@@@@@@@@@@@@@@@@
@@@@@@@@@@@@@@@@@@@@
@@@@@@@@@@@@@@@@@@@@
@@@@@@@@@@@@@@@@@@@@
@@@@@@@@@@@@@@@@@@@@
@@@@@@@@@@@@@@@@.@@@
@@@@.@@@@@@@@@@..@@@
.@@...@@@@@.@@@@..@@
.@..@@@@@@...@.@.@.@
..@...@@@.@.@.......
.@.@@.@@......@.@@@@
.........@.@.@@@@@@@
@.@.@.@.@@@@@@@@@@@@
@@...@@@@@@@@@@@@@@@
@@@.@.@.@@@@@@@@@@@@
@@@......@@@@@@@@@@@
@@@@@.@.@@@@@@@@@@@@
16
9 13 0
16 11 0
1 15 0
5 17 0
5 19 0
6 18 0
0 11 1
5 18 1
18 12 1
11 12 1
4 12 1
7 19 2
2 14 2
15 13 2
0 14 2
12 11 2

0 13 0
4 10 0
3 15 0
6 18 0
12 14 0
16 10 0
0 14 1
15 12 1
1 14 1
11 13 1
4 9 1
11 12 2
14 11 2
5 13 2
15 13 2
12 11 2
