width 20
height 20
........@@......@...
........@@..........
........@...........
@......@..@.........
........@...........
......@.......@...@.
.....@..............
........@......@....
..@.................
@..........@...@....
..@..@..........@...
......@......@.....@
...................@
...........@.......@
............@...@...
..@...........@.@...
....................
....@....@....@.....
...............@..@.
...........@........
8
9 15 0
13 16 0
12 3 0
5 8 0
18 19 0
4 11 0
14 9 0
16 8 0

1 10 0
17 6 0
2 12 0
1 5 0
13 16 0
4 11 0
13 8 0
2 17 0
