width 20
height 20
@@.....@@..........@
.@...@..............
........@..@..@..@..
....................
....................
...................@
@....@...@.@.@...@..
...@......@...@.....
...................@
.........@.....@...@
.......@...@....@..@
...@................
@.....@..@.........@
@..@........@.@.@...
.....@.@.....@.@....
....@.....@.........
.@..........@.......
....@..@.....@......
..........@.........
...................@
8
17 7 0
8 9 0
9 15 0
7 5 0
3 2 0
7 8 0
6 9 0
18 8 0

16 7 0
15 10 0
10 17 0
11 16 0
10 9 0
18 0 0
19 18 0
4 6 0
