width 20
height 20
@@.@@.@.@@@@@@....@@
@........@@@@@.@.@.@
@@.@@.@@.@@@@@@.....
@.@.@@.@..@.@@@@.@.@
.........@...@@@@@.@
@.@@.@.@.@@.@.@@@@..
@@@@@@.@@.@...@.@@.@
@.@@....@...@.......
.....@.@@.@.@@.@@.@.
.@.@.@.@...@@@@@.@..
.@@..@@@@@..@@@....@
...@..@@@..@.@.@.@..
.@..@..@@@.....@@..@
@.@.@.@.@.@@.@..@.@@
@...@......@@..@@@@@
@@@@..@.@.@@.@...@@@
@@@@@..@@......@....
@@@@.@.@@.@.@@@@.@@.
@@@.....@@....@@.@@@
@@@@.@.@@@@.@@@@@@@@
10
4 18 0
12 18 0
5 4 0
19 16 0
12 13 1
1 13 1
17 0 1
2 0 2
13 6 2
4 19 2

4 19 0
5 1 0
6 4 0
13 12 0
17 10 1
5 14 1
14 14 1
17 8 2
0 10 2
18 10 2
