width 20
height 20
@@@@@@@@@@@@@@@@@@@@
@@@@@@@@@@@@@@@@@@@@
@@@@@@@@@@.@@@@@@@@@
@@@@@.@@.@..@@@@@@@@
@@@...@....@@@@@@@@@
@@.@.@.@.@.@@@@@@@@@
@@........@@@@@@@@@@
.@.@.@@.@..@@@@@@@@@
....@.@@.@@.@@@@@@@@
@.@..........@@@@@@@
...@.@.@.@@.@@.@.@@@
@.@@@..@..@.......@@
@@@@@@.@.@@.@@.@@..@
@@@@@@@..@..@@@@@@@@
@@@@@@@.@..@.@.@@@.@
@@@@@..@.@..........
@..@.@.@...@.@.@@.@.
@@.......@@...@@@@@@
@@@@.@@.@@..@..@@@@@
@@@@@....@@@..@@@@@@
10
5 9 0
16 10 0
11 13 0
10 15 0
4 6 1
4 4 1
12 15 1
12 16 2
10 7 2
7 13 2

6 11 0
5 3 0
16 11 0
4 7 0
6 6 1
4 6 1
5 8 1
6 5 2
3 4 2
8 17 2
