width 20
height 20
@@@@@@@@@@@....@..@.
@@@@@@@@@@@.@@..@...
@@@@@@@@@@@@...@.@@.
@@@@@..@..@@@@......
@@@@@@...@.@@.@.@@@.
@@@@@@@@.........@..
@@@@@@@.@.@@.@@.@.@.
@@@@@.@.@@@@.@@@@.@.
@@@@@...@@@@@.@.@...
@@@@..@.@@@@@.....@@
@@@.@@...@@.@.@@@...
@@.....@.......@@@.@
@@@.@@@.@@@.@.@@@@@@
@@@.....@..@@@@@@@@@
@@@.@.@...@@@@@@@@@@
@@@@...@@@@@@@@@@@@@
@@@@@.@@@@@@@@@@@@@@
@@@@@@@@@@@@@@@@@@@@
@@@@@@@@@@@@@@@@@@@@
@@@@@@@@@@@@@@@@@@@@
5
12 0 0
13 12 0
8 11 0
13 9 0
7 4 0

3 13 0
4 15 0
6 3 0
11 5 0
10 4 0
