width 20
height 20
@@@@@@@@@@@@@@@.....
@@@@@@@@@@@@@@@@.@.@
@@@@@@@@@@@@@@@@@..@
@@@@@@@@@@@@@@@..@.@
@@@@@@@@@@@@@...@..@
@@@@@@@@@@@@..@@.@.@
@@@@@@@@@@@@@.......
@@@@@@@@@@@@@@.@@@@.
@@@@@@@@@@.@@.@@@.@.
@@@@@@@@@...........
@@@@@@@@@@.@@@.@.@.@
@@@@@@@@@.@....@@.@.
@@@@@@@@....@@..@...
@@@@@@@@.@@..@.@.@.@
@@@@@@@...@@@@......
@@@@@@.@.@.@@@.@@.@@
@@@@@..@.@..@....@@@
@@@@@@..@.@..@.@...@
@@@@@@@.@...@.@@.@@@
@@@@@@@...@......@@@
5
17 2 0
16 18 0
10 15 0
10 16 0
13 19 0

17 15 0
11 19 0
17 0 0
8 13 0
16 19 0
