width 20
height 20
@..@@@@@@@@@@@@@@@@@
@@.@@@@@@@@@@@@@@@@@
@@..@@@@@@@@@@@@@@@@
@@.@.@@@@@@@@@@@@@@@
.....@@@@@@@@@@@@@@@
.@.@..@.@@@@@@@@@@@.
..@..@..@@@@@@@@@@@.
.@@@.@.@@@@@@@@@@@..
...@...@@@@@@@@@@.@.
@@..@@.@@@@.@@.@....
@@.@.@@.@.......@@@.
@@........@@.@@.....
@@@.@.@.@@@.@@..@.@@
@...@@....@...@..@@@
..@@@@@.@@@.@.@@.@@@
.@......@@@@...@....
@..@@.@.@@@.@.@@@@.@
@@...@@.....@..@@@@@
.@.@.@..@@@...@@@@@@
....@@@.@@..@.@@@@@@
5
2 4 0
14 17 0
8 13 0
12 18 0
18 16 0

16 15 0
11 14 0
8 13 0
9 17 0
19 5 0
