width 20
height 20
@.........@@@@@@@@@@
@@.@@.@@.@@@@@@@@@@@
@..@...@.@@@@@@@@@@@
..@.@.@.@@@@@@@@@@@@
@@@......@@@@@@@@@@@
....@@.@..@@@@@@@@.@
@@@.@@@..@@@@@@@@@..
@@@.@@@@.@@@.@.@.@.@
@@@.@@@...@.........
@@@...@@.@@.@.@@@.@@
@@@.@.@@.@@@@.@@..@@
..@..@.@.@..@@.@.@@@
.@@@...@@@.@@.....@.
.@..@.@.....@.@.@...
...@..@@@.@@@..@@.@.
.@@@.@@...@@@@..@..@
.....@.@.@@@@.@..@@@
@@.@..........@.@.@@
@@@..@.@.@@@@......@
@@..@..@@.....@@.@@@
5
16 12 0
2 5 0
0 3 0
6 18 0
14 8 0

9 19 0
5 9 0
8 6 0
12 7 0
14 8 0
