width 20
height 20
...........@........
....................
..........@.........
....@....@...@......
....@@..............
..@...@......@@.....
......@@...@........
@.....@.............
...@.....@........@.
....@..@...@.@......
.....@.........@....
@........@..........
............@...@.@.
....................
......@....@........
...@.....@..........
................@@..
....................
.........@.@..@.....
....................
12
9 5 0
16 7 0
14 16 0
16 6 0
19 16 1
10 4 1
12 9 1
10 9 1
12 15 2
7 10 2
0 14 2
7 2 2

7 19 0
9 2 0
7 1 0
3 13 0
5 1 1
15 6 1
2 19 1
16 3 1
0 0 2
15 4 2
3 17 2
15 14 2
