width 20
height 20
@.......@...........
...................@
...................@
...............@....
............@.......
....@..@.@..........
....................
@@@..@....@@..@..@..
@@@@.@..............
@@@@.........@......
@@@@.......@.....@..
@@@@................
@@@.......@.........
......@....@.@....@.
....................
....................
@......@......@.....
........@..@........
..@.................
..................@.
12
2 15 0
5 2 0
16 5 0
14 3 0
9 9 1
11 1 1
15 16 1
8 4 1
9 2 2
8 6 2
12 17 2
13 16 2

19 0 0
14 18 0
7 17 0
12 9 0
15 8 1
10 19 1
19 9 1
17 18 1
14 14 2
15 13 2
15 19 2
2 2 2
