width 20
height 20
..@..@..............
........@@......@@@@
........@........@@@
....@..........@.@@.
............@.......
.................@..
..@....@......@.@...
........@.@.........
.................@..
.....@.......@......
....................
....@...............
.........@..........
........@.@.......@.
.....@.....@...@....
@..@............@..@
.....@.............@
.......@......@....@
...................@
........@...@......@
12
14 19 0
7 8 0
9 4 0
5 5 0
3 19 1
1 15 1
14 5 1
6 13 1
6 6 2
6 2 2
15 16 2
4 7 2

15 19 0
19 3 0
14 19 0
12 13 0
7 11 1
17 12 1
6 19 1
17 6 1
18 14 2
18 19 2
2 7 2
18 18 2
