width 20
height 20
@.....@@@.@@..@.....
....................
....................
...............@....
..@...@.....@.......
..@.................
......@...@..@...@..
....................
................@...
...@........@.......
.....@.@............
....@...........@...
.............@......
....................
...@................
@...................
@....@.......@......
......@.@...........
..............@.....
@..............@....
12
7 13 0
3 5 0
1 6 0
4 0 0
9 5 1
15 11 1
19 6 1
13 14 1
5 12 2
15 2 2
18 14 2
7 17 2

13 7 0
16 5 0
7 19 0
13 10 0
2 17 1
0 6 1
1 18 1
14 9 1
1 15 2
17 10 2
19 11 2
18 3 2
