width 20
height 20
@@@@..@..@@@@@..@@@@
@@@..@@.@@@@@..@.@.@
.@..@...@@@@@@......
...@.@@..@@@@@@@.@@@
@.@@....@.@@@@....@@
.....@.@.......@@@@@
.@@@.@@@@.@.@@...@.@
...@.@@@@@@@@..@....
@.@@@@@@......@..@@.
...@.@@.@.@.@..@@@@.
.@.........@..@@....
.@@.@.@.@@..@@@@.@.@
..@@.@@..@.@@@@@@@@@
@.@...@@@@@@@@@@@@@@
@...@...@@@@@@@@@@@@
@.@.@.@@@@@@@@@@@@@@
@@...@@.@@@@@@@@@@@@
@@@@....@@@@@@@@@@@@
@@@@@@@....@@@@@@@@@
@@@@@@@.@.@@@@@@@@@@
10
0 10 0
17 10 0
14 4 0
0 6 0
7 0 0
19 8 0
4 12 0
5 2 0
16 10 0
15 0 0

5 14 0
8 8 0
13 7 0
3 15 0
3 1 0
14 5 0
16 10 0
2 5 0
7 19 0
9 18 0
