width 20
height 20
@@@@@.@@...@@@@@@@@.
@@@@...@.@.@@.@.@@@.
@@@.@@.@@@.@....@@@.
@@..........@@@..@..
@@@.@.@.@.@.@...@.@.
@@@..@..@@.@@.@@@...
@@..@@@@..........@.
@@@..@@@@.@.@@@.@@..
@@@.@.@@...@.@..@..@
@@@.@..@@.@...@@..@@
@@..@.@.....@.@..@.@
@@@.....@@@@@@@@...@
@@.@.@@@@.....@@@@.@
@..@.@....@.@..@.@.@
@@..@.@.@.@.@@......
..@......@@@@@@@@.@.
@.@@.@@.@@@@@@@@@@..
......@...@...@@@@@.
@@.@@@..@..@.@@@@@@@
....@@@..@...@@@@@@@
10
3 17 0
15 1 0
18 8 0
8 8 0
10 2 0
6 18 0
7 18 0
3 7 0
4 16 0
11 4 0

14 13 0
7 5 0
19 7 0
8 10 0
19 2 0
19 5 0
5 3 0
3 3 0
14 6 0
4 11 0
