width 20
height 20
@@@@@@@@@@.@@@@@@@@@
@@@@@@@@@...@@@@@@@@
@@@@@@@@..@@@@@@@@@@
@@@@@@@.@..@@@@@@@@@
@@@@@@@...@.@@@@@@@@
@@@..@@@@...@@@@@@@@
@.@.@.@@.@@.@@@@@@@@
.............@@@@@@@
@.@.@.@.@.@.@@@@@@@@
@@@@...@...@@@@@@@@@
@@@@@.@@@.@@@@@@@@@@
@@@@@@@@...@@@@@@@@@
@@@@@@@@@.@@@@@@@@@@
@@@@@@@@....@@@@@@@@
@@@@@@@@.@.@@@@@@@@@
@@@@@@@@@..@@@@@@@@@
@@@@@@@@.@.@@@@@@@@@
@@@@@@@....@@@@@@@@@
@@@@@...@.@@@@@@@@@@
@@@@@.@..@@@@@@@@@@@
10
8 16 0
10 5 0
10 16 0
9 11 0
10 13 0
7 7 0
7 19 0
9 7 0
5 6 0
10 3 0

5 9 0
3 7 0
11 5 0
9 17 0
10 13 0
11 7 0
11 1 0
7 17 0
8 13 0
6 18 0
