width 20
height 20
@@@@@@@@@@@@@@@@@@@@
@@@@@@@@@@@@@@@@@@@@
@@@@@@@@@@@@@@@@@@@@
@@@@@@@@@@@@@@@@@@@@
@@@@@@@@@@@@@@@@@@@@
@@@@@@@@@@@@@@@@@@@@
@@@@@@@@@@@@@@@@@@@.
@@@@.@@@@@@@@@@@@@..
@@@...@@@@@@@@@@@@@.
@@@@.@.@.@.@@@@@@@..
@@@.........@@@@@.@.
@@@@.@.@.@.@@@@@@...
@@@..@@...@@@@..@.@.
@@@@@@@@.@..@@@....@
@@@@@@@....@.@@@@.@@
@@@@@@@@.@..........
@@@@@@@@@@@.@.@@@@@@
@@@@@@@@@@..@@@@@@@@
@@@@@@@@@@@.@@@@@@@@
@@@@@@@@@@@@@@@@@@@@
10
19 8 0
3 8 0
12 14 0
7 14 0
10 13 0
19 7 0
13 15 0
10 15 0
4 11 0
11 15 0

4 12 0
8 10 0
19 15 0
13 16 0
9 14 0
13 15 0
19 9 0
6 11 0
12 15 0
17 13 0
