width 20
height 20
....................
...............@....
.....@......@......@
................@...
.@.@.....@@@.@@.....
.....@....@@@@@.....
..........@.@@@.....
..@.............@...
......@........@....
....@.....@.........
..............@.....
...@........@....@..
..@....@............
......@...@...@.....
....@...............
....................
..........@..@......
..@..@.........@..@.
....................
.......@............
1
18 2 0

10 0 0
