width 20
height 20
..@@...........@@...
....................
............@.......
..............@.....
.....@...@..........
....................
............@.......
..@.................
......@......@......
....................
..........@.........
@....@.........@....
@.......@...........
....................
.......@..@..@......
..................@.
............@....@@.
......@..........@@.
...........@.....@@.
........@@.......@@.
1
7 11 0

8 2 0
