width 20
height 20
@..................@
....................
...@.......@........
.......@.@.......@..
..................@.
........@......@....
.@...........@......
........@...........
....@.....@.........
......@.....@.......
..@..@.......@...@..
.........@........@.
......@.........@...
..@.................
...@.....@..........
..............@..@..
@.....@..@..@.......
@...................
.......@............
.......@............
1
5 18 0

17 0 0
