width 20
height 20
@@@@@@@@@@@@@@@@@@@@
@@@@@@@@@@@@@@@@@@@@
@@@@@@@@@@@@@@@@@@@@
@@@@.@@@@@@@@@@@@@@@
@@@...@@@@@@@@@@@@@@
@@.@.@@@@@.@@@@@@@@@
@@...@.@@...@@@@@@@@
..@@....@@.@.@@@@@@@
@....@@..@...@@@@@@@
@.@@.@.@@.@@.@@.@@@@
.@.@...............@
.@.@.@.@.@@.@.@.@@@@
...@@@.@.@@@.@...@@@
@@......@@@....@..@@
@@@.@@.@@@@.@@.@@...
@@@.@.@@@@@@@@.@@@@@
@@....@@@@@@@...@@@@
@@@.@..@@@@@@@.@@@@@
@@@@@.@@@@@@...@@@@@
@@@@..@@@@@@.@..@@@@
11
14 13 0
10 7 0
9 9 0
18 10 0
8 8 0
2 6 0
11 14 0
2 16 0
4 5 0
6 11 0
7 10 0

12 7 0
2 12 0
11 10 0
17 10 0
14 18 0
2 6 0
15 12 0
17 13 0
14 15 0
5 13 0
10 10 0
