width 20
height 20
@@@.@@@@@@@@@@@..@@@
..@.@@@@@@@@@@.@.@@@
@.@..@@@.@.@.......@
@...@.@....@.@@@.@.@
..@@@.@.@@.@.@.@@...
@..@..@@.......@@@.@
@.@.@....@@.@.@@.@..
......@@@...@.....@@
@.@.@@.@@@.@@.@.@.@.
@.@@@@..@....@.@....
@@@@@.@..@@@...@.@.@
@@@@@.@@.....@@@.@@@
@@@@..@.@.@@...@....
@@@@@......@.@@.@.@.
@@@@@@@.@.@@@...@..@
@@@@@@...@.@@.@.@@..
@@@@@@@.@..@.@...@.@
@@@@@@@...@..@@@...@
@@@@@@@@.@..@@.@@.@@
@@@@@@@@@@@.........
11
6 9 0
8 17 0
15 7 0
1 1 0
9 13 0
10 11 0
7 15 0
10 16 0
14 5 0
5 11 0
15 16 0

14 12 0
10 15 0
18 2 0
14 10 0
11 6 0
15 16 0
14 1 0
8 17 0
14 9 0
8 18 0
5 10 0
