width 20
height 20
@@@@@@@.......@@@@@@
@@@@@.@@.@@@@.@@@@@@
@@@@.....@@@@@.@@.@@
@@@..@.@..@.@..@....
...@@..@@.....@..@.@
.@.@.@.@.@.@.@@@.@..
@......@..@@@@@@.@.@
@@.@.@.@.@@@@@@..@..
@...@@@...@@@@@.@@@@
@@.@@@@@.@.@@.......
@@..@@@.......@@.@@.
@.@.@@..@.@.@..@.@@@
....@.@@.@.@.@.@.@@@
@.@.............@@@@
.@..@.@@@.@@.@@..@.@
...@@@.@....@...@...
@.@.@@..@.@.@.@...@.
.@....@.@@..@..@@@@.
...@@.@.@.@.@.@..@@.
@.@..........@@@....
11
3 8 0
18 4 0
10 19 0
11 16 0
5 17 0
9 3 0
13 16 0
3 3 0
17 19 0
4 6 0
15 9 0

11 4 0
18 4 0
5 17 0
12 14 0
5 2 0
3 10 0
19 16 0
3 12 0
17 15 0
5 18 0
3 3 0
