width 20
height 20
@@@@@.@@.@.@@@@@@@@@
@@@@.......@@@@@@@@@
@@@@.@.@@.@@@@@@@@@@
@@@.@@@....@@@@@@@@@
@.@.@@.@.@@@@@@@@@@@
@.@....@.@@@@@@@@@@@
....@@.....@@@@@@@@@
.@.@..@.@.@@@@@@@@@@
.@...@...@@@@@@@@@@@
.@.@@@@.@@@@@@@@@@@@
.@.@@@@@.@@@@@@@@@@@
..@.@.@@.@@@@@@@@@@@
@.@........@@@@@@@@@
@...@.@@.@@@@@@@@@@@
@@.@..@@@@@@@@@@@@@@
...@@@@@@@@@@@@@@@@@
.@.@@@@@@@@@@@@@@@@@
..@@@@@@@@@@@@@@@@@@
@@@@@@@@@@@@@@@@@@@@
@@@@@@@@@@@@@@@@@@@@
11
5 11 0
0 15 0
5 7 0
5 12 0
0 16 0
1 11 0
0 7 0
4 14 0
2 9 0
2 6 0
8 3 0

8 6 0
7 3 0
6 6 0
3 5 0
0 11 0
9 6 0
4 2 0
1 11 0
8 1 0
8 3 0
8 4 0
