width 20
height 20
..@..@@@@@@@@@@@@@@@
.@.@..@...@@@@@@@@@@
.@...@.@.@@@@@@@@@@@
...@@....@@@@.@@@@.@
@.@.@@@.@@@@@.@.@...
@.......@@@@......@@
..@@.@@.@@@.@@@@@...
@@@....@@@@.@@.@..@@
.@.@@.@@.@.......@@@
...@.......@@.@.@@@@
.@..@.@.@.@@@@@@@@@@
..@..@@.@...@@@@@@@@
.@@@@@@@.@.@@@@@@@@@
.@@@@.@.....@@@@@.@.
..@@...@@@.@..@@....
@....@.......@@.@.@.
@.@@.@.@.@.@......@.
@.@@.@@@@@.@@.@.@@..
@...@@@@..@.@@...@@.
@@@@@@@@@......@.@@.
11
15 9 0
4 6 0
8 13 0
19 19 0
0 8 0
0 13 0
12 5 0
16 16 0
9 9 0
10 8 0
16 19 0

18 4 0
5 5 0
15 8 0
17 13 0
1 15 0
17 6 0
10 9 0
4 1 0
19 17 0
11 8 0
17 16 0
