width 20
height 20
..........@....@@@..
....................
....@.@.....@.......
..................@.
.......@......@.@...
.............@......
....................
......@...@.@.......
...............@....
....................
..@.........@...@...
........@...........
....................
.....@...@.@........
...................@
...@...@...@.@......
..........@.........
.....@..@.......@...
..............@.....
...@................
10
14 16 0
18 6 0
6 14 0
18 0 0
7 1 1
11 19 1
5 5 1
9 4 2
17 2 2
19 10 2

0 0 0
18 6 0
8 0 0
6 17 0
0 16 1
15 19 1
6 1 1
18 19 2
8 19 2
0 19 2
