width 20
height 20
........@@.......@@@
................@@@@
....@....@....@.@@@@
.........@@.......@@
.........@@........@
.....@...@@.........
...@..@.............
....................
@...................
.........@..........
..........@..@......
.................@..
..@........@........
..........@.....@...
....@.........@..@..
........@...@.......
....................
......@.............
..@............@..@.
..................@@
9
13 11 0
15 12 0
2 2 0
19 16 1
19 18 1
16 10 1
4 8 2
1 11 2
7 8 2

5 1 0
4 4 0
18 17 0
3 14 1
0 0 1
16 18 1
3 8 2
7 15 2
12 17 2
