width 20
height 20
@@..................
@@.@........@.....@.
@@......@.@....@..@@
.......@.....@......
....@...............
..........@...@.....
.............@....@.
....................
@......@............
....@@..............
...............@....
................@.@.
...@......@.........
.........@..........
....................
....@..........@....
..........@.@.......
....................
...........@..@@....
........@...........
9
13 7 0
12 11 0
10 3 0
4 14 1
17 7 1
7 17 1
14 0 2
15 14 2
9 17 2

10 14 0
0 4 0
19 18 0
5 15 1
7 18 1
19 6 1
0 19 2
14 7 2
7 12 2
