width 20
height 20
@@@@@@@...@....@@@@.
@@@@.@.@.@.@.@..@@..
@@@@.........@.@@.@.
@@@..@@.@@.@@.......
@@@@.@.@@@@@@@.@@.@.
@@@.....@..@@..@.@..
@@.@.@.@..@@..@....@
@....@.@@..@.@@@.@@@
..@@@@...@....@@@@@@
.@@@@..@.@.@.@@..@@@
@@@@@.@@..@..@@.@@@@
@@@@@@@.@.@@@.....@@
@@@@@@......@.@.@...
@@@@@..@@.@....@..@@
@@@@..@@@@@@@.@.@...
@@@@@..@@.@@@@....@@
@@@@..@.@.@@@@@@@.@.
@@@@@......@@@@@....
@@@@@@.@.@...@@@@.@.
@@@@@@@@@@@.@@@@@@@@
3
2 7 0
10 2 0
1 7 0

17 4 0
8 9 0
9 12 0
