width 20
height 20
.........@@@........
..@......@@@......@@
.@...@...@@..@....@@
.........@.........@
@....@@.@...........
....................
....@..........@....
..........@.........
...........@.@......
.............@....@.
..@...@.............
..............@.....
....................
........@.........@.
...@...........@....
.........@....@.....
......@.....@.......
.......@.......@@...
....................
....................
15
7 2 0
13 16 0
12 14 0
9 10 0
18 5 0
2 11 1
14 0 1
0 11 1
1 4 1
10 12 1
17 1 2
9 8 2
0 18 2
15 8 2
14 5 2

6 9 0
12 17 0
1 5 0
8 0 0
7 19 0
2 11 1
12 4 1
4 8 1
10 19 1
10 11 1
18 12 2
15 13 2
2 12 2
3 10 2
14 5 2
