width 20
height 20
...................@
........@...........
..@.................
.....@..........@...
..............@.....
........@....@......
.@....@.............
..........@..@......
....@..@............
....................
..@..@..@..@..@.....
....................
.....@...@..........
...........@.@......
.......@..........@.
...@...@............
.......@............
.......@....@.@.....
.......@............
@@....@@@@......@...
15
3 1 0
14 13 0
17 12 0
10 0 0
14 3 0
18 16 1
9 7 1
19 11 1
11 14 1
18 9 1
8 4 2
6 12 2
16 13 2
14 15 2
3 14 2

7 6 0
2 3 0
7 10 0
15 0 0
3 2 0
17 17 1
8 2 1
3 12 1
12 3 1
12 1 1
7 4 2
8 8 2
16 12 2
19 14 2
12 9 2
