width 20
height 20
....@@..............
...@................
....................
....................
............@.@.....
.................@..
.......@..@.........
.........@..........
.....@....@.....@...
.......@.......@.@..
@@..@.......@.......
@@......@.@..@...@..
@@....@.............
@...................
..............@.....
..@.@...........@.@.
..........@...@.....
...@.@.......@....@.
....................
....................
15
5 4 0
8 16 0
19 0 0
7 16 0
5 12 0
5 13 1
14 13 1
6 14 1
1 3 1
6 6 1
14 12 2
18 14 2
12 2 2
8 10 2
17 1 2

1 4 0
6 11 0
10 3 0
6 19 0
10 13 0
16 0 1
1 1 1
4 13 1
4 12 1
8 4 1
0 15 2
15 13 2
7 1 2
13 1 2
19 10 2
