width 20
height 20
....................
.......@..@.........
.............@..@...
...@................
........@...........
..@.@...............
..............@.....
.@.@.....@..@.......
..............@.....
.....@......@.......
........@..@........
@...@...............
...........@...@.@..
@@.....@............
@@...@..@...@.......
@@.......@..........
@@.@................
@@@......@..........
@@@..............@..
....................
16
13 10 0
7 6 0
14 11 0
7 16 0
4 19 0
1 10 0
5 18 0
18 10 0
0 2 0
8 19 0
4 4 0
14 5 0
8 13 0
13 12 0
4 14 0
13 7 0

0 19 0
2 8 0
10 7 0
5 13 0
18 2 0
1 5 0
15 1 0
1 8 0
7 10 0
10 16 0
16 19 0
11 9 0
19 2 0
13 8 0
4 15 0
0 0 0
