width 20
height 20
@...@@............@@
....................
@@.....@............
@@..@......@.@......
@....@.@.......@....
@.....@.............
@................@..
@....@...@...@......
@.............@..@..
@.....@....@........
.................@..
....@...............
..@..........@@.....
......@......@......
@..@......@..@...@..
......@.@...........
..@...........@.....
..............@.....
.......@............
....................
16
11 1 0
3 0 0
10 9 0
18 17 0
18 13 0
15 12 0
16 15 0
1 14 0
3 1 0
1 18 0
13 11 0
1 19 0
16 6 0
0 12 0
2 17 0
6 6 0

11 12 0
4 13 0
5 11 0
11 0 0
5 10 0
9 2 0
14 6 0
8 1 0
16 15 0
3 7 0
16 9 0
7 17 0
4 19 0
19 1 0
18 1 0
15 13 0
