width 20
height 20
.......@............
....................
...@...........@....
...........@........
.@........@.........
....@...@......@..@.
....@@...........@.@
.....@.....@.......@
...@@..@..@.@.@.....
....................
............@...@...
.@......@..@@.......
.................@..
...........@....@...
@..@................
.........@@...@...@.
.@...@..@@@@...@....
....@....@@@....@...
.........@@.........
.........@@@@@......
16
14 0 0
16 14 0
18 0 0
0 0 0
10 12 0
9 8 0
5 19 0
17 16 0
5 11 0
4 0 0
15 11 0
6 14 0
9 13 0
16 11 0
2 17 0
2 6 0

19 10 0
14 0 0
6 15 0
3 1 0
8 8 0
19 19 0
5 9 0
1 8 0
10 14 0
7 3 0
15 11 0
19 11 0
14 2 0
5 0 0
10 13 0
0 6 0
