width 20
height 20
...@@.....@@........
....................
...@.......@....@...
...............@....
..@..@.@..@.@.......
.........@........@.
@.....@........@....
...................@
.@...........@......
......@....@...@....
........@.......@...
...........@........
...@...@.......@....
....................
.@.....@......@.....
..@.................
.........@.......@..
.......@.@..........
...............@.@..
......@@@...@.......
16
19 14 0
4 10 0
0 3 0
12 12 0
8 2 0
13 1 0
4 1 0
15 19 0
7 18 0
19 2 0
1 19 0
13 2 0
16 12 0
0 12 0
13 13 0
16 5 0

9 12 0
6 14 0
19 1 0
11 10 0
16 18 0
0 19 0
0 17 0
1 9 0
11 18 0
13 16 0
18 0 0
7 9 0
19 14 0
6 15 0
0 1 0
19 15 0
