width 20
height 20
....................
....................
.....@...........@..
.......@....@..@....
....................
.@...@......@..@....
.........@..........
...........@.@......
......@.@.....@.....
....................
..........@.........
......@..@..........
......@............@
..@....@....@...@..@
...................@
@...@.....@.......@@
..........@........@
.@.................@
...@....@..........@
...................@
16
2 14 0
16 11 0
16 5 0
8 0 0
11 14 0
3 3 0
7 0 0
12 10 0
12 15 0
1 6 0
2 18 0
13 18 0
18 8 0
3 5 0
4 5 0
9 3 0

1 2 0
0 14 0
0 19 0
17 17 0
1 0 0
17 15 0
5 11 0
12 0 0
2 0 0
14 15 0
1 14 0
8 14 0
17 9 0
9 3 0
8 0 0
10 0 0
