width 20
height 20
..@@................
.....@..............
....................
.......@............
....................
....@..@.....@.@....
........@...........
.............@.@....
.........@....@...@.
.@...@..............
.......@@...........
..@@........@...@...
.@..@...............
..........@.........
.....@..............
...@............@...
.@....@.............
................@...
@.......@..........@
@@@...........@....@
16
3 12 0
14 11 0
1 17 0
16 12 0
17 16 0
3 6 0
6 17 0
19 4 0
1 18 0
9 10 0
11 10 0
7 17 0
16 0 0
10 7 0
10 1 0
19 0 0

19 2 0
11 11 0
19 0 0
16 13 0
17 16 0
5 2 0
3 7 0
2 17 0
0 10 0
9 10 0
11 19 0
6 3 0
2 10 0
5 5 0
4 0 0
6 1 0
