width 20
height 20
....................
................@...
...............@....
....................
@...............@...
@..@@..@.@..........
............@..@....
.......@..@.........
.........@...@......
......@.............
....@......@.......@
........@......@.@.@
.............@.....@
....@.......@.....@.
....................
....................
..............@.@...
.....@....@.........
.......@............
....................
16
13 7 0
8 3 0
17 14 0
2 9 0
5 16 0
18 9 0
11 9 0
11 3 0
11 8 0
15 4 0
1 1 0
15 7 0
1 8 0
3 19 0
7 10 0
19 19 0

11 13 0
17 14 0
1 0 0
10 13 0
3 17 0
13 18 0
16 10 0
7 10 0
14 13 0
2 10 0
3 4 0
14 17 0
12 12 0
16 18 0
5 13 0
1 1 0
