width 20
height 20
...............@....
.....@.....@........
..........@.........
....................
......@..........@.@
.........@.........@
.@.@...@....@......@
..@................@
........@..@........
....@...........@...
................@...
..@......@..........
.@.@.@..............
......@.............
........@.....@..@..
.@..@...............
...@.....@...@......
............@.......
@@@...@.@...........
@@@@................
10
7 9 0
15 4 0
17 12 0
18 10 0
17 6 0
2 6 0
2 8 0
13 3 0
6 17 0
5 11 0

16 2 0
16 8 0
8 7 0
0 0 0
0 17 0
14 7 0
10 12 0
18 10 0
15 18 0
19 17 0
