width 20
height 20
....................
...@....@........@..
...@................
.@...........@......
...........@....@...
@...................
..@.......@.......@.
@...@....@..........
@...............@...
......@....@........
................@.@.
.......@.@.@...@.@@@
.................@@.
..@....@............
....@...............
.........@.......@..
.....@@.............
....@@@.........@@@@
.....@@.......@..@@@
.................@@@
10
14 4 0
10 4 0
2 12 0
12 1 0
12 9 0
10 3 0
7 1 0
15 3 0
14 3 0
3 16 0

1 19 0
2 19 0
4 8 0
9 2 0
11 14 0
0 11 0
9 4 0
14 12 0
14 8 0
15 16 0
