width 20
height 20
.....@@............@
.........@.@...@...@
......@..@.....@@...
........@...........
.@..................
..@.............@...
.......@..........@.
....................
.............@......
...@......@...@.....
.........@..........
....................
..@.................
.@...@..............
.................@..
...@@..........@....
...@@.@.....@@.....@
....................
......@..@..........
..@.@@@@............
15
15 17 0
12 12 0
10 15 0
12 4 0
11 2 0
6 1 0
0 6 0
6 5 0
0 16 0
10 4 0
15 9 0
2 9 0
7 16 0
13 14 0
16 13 0

0 0 0
18 4 0
14 8 0
10 1 0
3 5 0
17 18 0
15 17 0
19 14 0
4 13 0
1 19 0
1 6 0
1 12 0
18 14 0
1 1 0
5 4 0
