width 20
height 20
..@.................
...@.........@.@....
.................@..
............@.......
...@................
................@...
.@.............@...@
......@.............
.....@..............
....................
....@......@....@...
......@..@...@.@.@..
.@..................
..@..@...@...@......
.....@..............
................@...
..@.@..@............
................@...
@...................
@...................
15
16 13 0
7 9 0
0 15 0
8 7 0
9 17 0
7 18 0
13 2 0
0 11 0
6 4 0
7 1 0
0 0 0
10 5 0
12 13 0
10 17 0
2 19 0

16 14 0
16 0 0
1 18 0
12 8 0
16 7 0
13 19 0
0 7 0
13 8 0
4 7 0
1 14 0
1 5 0
19 13 0
1 10 0
19 9 0
13 5 0
