width 20
height 20
@@@..@..@.@......@.@
@@@@.@@.@...@.@.@...
@.@......@@.@..@.@@.
..@@.@@.@.@..@......
@.....@.....@@@.@.@.
@@@@@..@@.@...@.@@@.
@@@@@@@@@@@@.@@....@
@@@@@@@@@@@@@@@@.@.@
@@@@@@@@@@@@@@@@@@@@
@@@@@@@@@@@@@@@@@@@@
@@@@@@@@@@@@@@@@@@@@
@@@@@@@@@@@@@@@@@@@@
@@@@@@@@@@@@@@@@@@@@
@@@@@@@@@@@@@@@@@@@@
@@@@@@@@@@@@@@@@@@@@
@@@@@@@@@@@@@@@@@@@@
@@@@@@@@@@@@@@@@@@@@
@@@@@@@@@@@@@@@@@@@@
@@@@@@@@@@@@@@@@@@@@
@@@@@@@@@@@@@@@@@@@@
15
13 2 0
15 4 0
4 0 0
14 2 0
18 6 0
14 0 1
8 2 1
5 4 1
13 0 1
19 3 1
3 4 2
12 3 2
4 2 2
9 1 2
9 3 2

3 2 0
15 4 0
7 0 0
10 1 0
19 5 0
18 0 1
13 0 1
5 4 1
19 2 1
19 3 1
17 1 2
16 0 2
12 5 2
11 0 2
15 6 2
