width 20
height 20
@.@.@@@@@@@@@@@@@@@@
..@..@@@@@@@@@@@@@@@
@.@.@.@.@@.@@@@@@@@@
............@@@@@@@@
.@.@.@.@.@@..@@@@@@@
@@.@..@@@@..@.@@@@@@
@..@@@@@@@@....@@@@@
..@@@@@@@@@@.@@@@@@@
@..@@@@@@@@@@@@@@@@@
.@.....@@@@@@@@@@@@@
...@.@@@@@@@@@@@@@@@
.@@......@@@@@@@@@@@
.@.@.@.@..@@@@@@@@@@
@.....@..@@@@@@@@@@@
..@.@..@@@@@@@@@@@@@
@.@@.@..@@@@@@@@@@@@
@@@@.@.@.@@@@@@@@@@@
@@@....@..@@@@@@@@@@
@@.@.@...@@@@@@@@@@@
......@.@@@@@@@@@@@@
15
7 2 0
9 17 0
1 10 0
7 18 0
4 19 0
5 13 1
2 3 1
11 3 1
2 19 1
6 16 1
8 4 2
1 13 2
0 4 2
6 11 2
12 7 2

1 19 0
8 4 0
5 11 0
6 15 0
7 19 0
11 4 1
0 19 1
6 17 1
2 13 1
11 5 1
8 3 2
12 4 2
6 4 2
6 16 2
5 9 2
