width 20
height 20
@@@@@@@@@@@@@@@@@@@@
.@@..@@@@@@@@@@@@@@@
....@@@@@@@@@@@@@@@@
.@@..@@@@@@@@@@@@@@@
...@.@@@@@@@@@@@@@@@
.@.@@.@@@.@@@@@@@@@@
..@@@..@..@@@@@@@@@@
.@@...@@.@@@@@@@@@@@
...@@.@..@@@@@@@@@@@
.@@....@.@@@@@@@@@@@
..@.@@@@..@@@@@@@@@@
.@@.@@@@.@@@@@@@@@@@
.@........@@@@@@@@@@
.@.@.@@.@.@@@@@@@@@@
....@@.@.@@@@@@@@@@@
@@.@@....@@@@@@@@@@@
@.....@.@@@@@@@@@@@@
@.@.@..@@@@@@@@@@@@@
...@@@@@@@@@@@@@@@@@
@.@@@@@@@@@@@@@@@@@@
15
6 9 0
4 7 0
6 14 0
1 6 0
0 4 0
1 14 1
7 12 1
5 8 1
3 16 1
8 14 1
1 4 2
1 2 2
3 10 2
2 8 2
3 3 2

6 9 0
4 3 0
2 8 0
9 6 0
0 6 0
0 18 1
4 4 1
0 7 1
5 15 1
5 16 1
2 14 2
0 10 2
2 12 2
0 2 2
0 3 2
