width 20
height 20
@..@@@.@@@..@@@@@@@@
..@@.@...@.@@@@@@@@@
@.@....@@@..@@@@@@@@
....@@.@@..@.@@@@@@@
@@@..@.@.@....@@@@@@
@.@.@..@...@.@@@@@@@
...@@@...@@@@@@@@@@@
.@@@@..@..@@@@@@@@@@
..@@.@.@.@@@@@@@@@@@
.@@.....@@@@@@@@@@@@
....@@.@.@.@@@@@@@@@
@.@..@......@@@@@@@@
...@@@@.@@@@@@@@@@@@
@.@@@@@@@@@@@@@@@@@@
@....@@@@@@@@@@@@@@@
@@.@.@@@@@@@@@@@@@@@
@@@@@@@@@@@@@@@@@@@@
@@@@@@@@@@@@@@@@@@@@
@@@@@@@@@@@@@@@@@@@@
@@@@@@@@@@@@@@@@@@@@
15
11 0 0
8 11 0
2 6 0
1 10 0
8 5 0
7 1 1
2 12 1
6 10 1
3 3 1
0 9 1
6 8 2
10 3 2
10 1 2
1 8 2
2 10 2

6 11 0
7 6 0
7 12 0
5 9 0
0 3 0
10 11 1
3 4 1
4 9 1
2 15 1
8 10 1
1 13 2
1 10 2
8 4 2
1 8 2
3 9 2
