width 20
height 20
@@@@@@@@@@@@@@@@@@@@
@@@@@@@@@@@@@@@@@@@@
@@@@@@@@@@@@@@@@@@@@
@@@@@@@@.@@@@@@@@@@@
@@@@@@@..@@@@@@@@@@@
@@@@@@@@.@@@.@@@@@@@
@.@@@@@.......@@@@@@
..@@@@.@@.@.@..@@@@@
.@.@@@.@..@@.@@@@@@@
........@......@@@@@
.@@.@.@.@.@@.@..@@@@
...@..@..@.@.@@@@@@@
@@@.@.@.@..@...@@@@@
@@@...@..@...@...@@@
@@@.@..@.@.@..@.@@@@
.@...@@.....@..@@@@@
...@.@.@.@@.@.@.@.@@
@.@@@.....@.@...@..@
@..@@@@@.@@@@@.@..@@
..@@@@@@.@@......@@@
15
11 6 0
1 11 0
16 13 0
15 13 0
1 19 0
11 17 1
4 13 1
17 17 1
14 15 1
13 14 1
9 10 2
5 17 2
15 16 2
3 14 2
13 7 2

15 17 0
1 7 0
7 9 0
1 16 0
5 14 0
17 17 1
7 6 1
8 18 1
5 11 1
0 19 1
3 14 2
14 13 2
15 10 2
9 9 2
4 13 2
