width 20
height 20
.............@@@@@@@
...@...@.@....@@@@@@
..............@..@@@
@.....@..........@@@
@...............@@@@
...@..@......@.@@@@@
....@.....@.......@@
..................@@
..@.....@......@..@@
.........@..........
...........@...@....
....................
....@.....@.........
....................
....@..@............
...@............@.@@
.@...@.......@......
.......@.......@....
@..................@
...................@
9
4 19 0
15 16 0
9 14 0
14 9 1
1 13 1
14 11 1
7 10 2
4 18 2
9 16 2

1 0 0
1 18 0
9 18 0
1 19 1
1 9 1
3 19 1
8 9 2
5 15 2
0 1 2
