width 20
height 20
....................
............@.......
........@@..........
.......@............
................@...
..........@.@....@..
....................
.@......@.@.........
.....@...@.@..@..@..
....................
..@.................
.@.@.....@......@...
.............@......
....@...@.....@.....
............@.......
........@..@..@..@@@
..@..............@@@
.......@........@@@@
.............@...@@@
.................@@@
9
10 15 0
10 1 0
3 1 0
19 7 1
12 0 1
17 9 1
8 3 2
8 8 2
12 4 2

14 9 0
11 4 0
0 18 0
1 17 1
6 4 1
0 16 1
1 18 2
6 15 2
12 3 2
