width 20
height 20
....................
@.....@........@....
@............@......
.........@..........
..@........@........
...@..@..@.....@....
............@.......
...@..............@.
..............@..@..
.....@....@.........
....................
.@.@.......@.@..@...
....................
.........@..........
...........@.@..@...
............@....@..
....................
...@..@..@..........
...............@....
...............@@...
9
15 12 0
15 3 0
0 16 0
18 12 1
15 6 1
7 1 1
4 4 2
14 11 2
2 11 2

14 18 0
0 11 0
2 16 0
19 1 1
15 13 1
16 5 1
9 4 2
18 18 2
16 0 2
