width 20
height 20
....................
....................
............@.......
........@......@....
............@.......
.....@..............
...........@@.......
....................
.........@....@@....
@..............@....
.............@......
@.....@..........@.@
@..........@..@.....
....................
.................@.@
...@.....@..........
........@....@...@..
.....@.........@....
....................
.@...........@@.....
9
14 1 0
8 11 0
7 6 0
12 19 1
3 1 1
4 11 1
11 9 2
7 18 2
1 15 2

10 12 0
8 11 0
17 10 0
16 7 1
3 19 1
11 17 1
18 10 2
15 10 2
11 5 2
