width 20
height 20
..@.......@@........
...@................
....................
....@..@@...........
.....@..@...........
........@...@.@.....
....................
.......@.....@.@....
.....@@@..@.........
@.....@.............
@...........@.......
@...@...............
@.....@...@.........
.....@......@...@...
....................
..........@.........
............@.....@.
................@...
.................@..
..............@.....
4
15 18 0
6 4 0
14 3 1
10 17 2

14 6 0
13 18 0
19 11 1
7 17 2
