width 20
height 20
@@@@@@@@@@@..@@@@@@@
@@@@@@@@@@..@@@@@@@@
@@@@@@@@@.@.@@@@@@@@
@@@@@@@@......@@@@@@
@@@@@@@@@.@@.@@@@@@@
@@@@@@@@..@@@@.@@@@@
@@@@@@@.@......@@@@@
@@@.@@....@.@.@@@@@@
@@@.@.@.@@.@...@@@@@
@@@.@......@@.@@@@@@
@.....@.@@..@@@@@@@@
@@.@@.@@...@@@@@@@@@
@@@.....@.@@@@@@@@@@
@@..@.@.@.@@@@@@@@@@
@.@.@@@@@..@@@@@@@@@
....@@@...@@@@@@@@@@
@.@..@@.@.@@@@@@@@@@
..@.@@...@@@@@@@@@@@
@.@@@@@.@@@@@@@@@@@@
@@@@@@@.@@@@@@@@@@@@
13
9 3 0
2 10 0
9 4 0
4 12 0
3 10 0
8 11 0
6 17 0
14 5 0
6 7 0
3 17 0
7 12 0
3 8 0
7 17 0

10 1 0
7 13 0
8 7 0
5 11 0
3 10 0
13 3 0
3 14 0
14 5 0
5 9 0
7 8 0
12 0 0
1 17 0
6 9 0
