width 20
height 20
@..@..@@@@@@.@@@.@.@
..@..@@@@@....@..@..
@.@.@..@@..@.@.@...@
......@.@.@......@.@
@.@@@......@.@.@..@@
....@@.@@.@@@@@@@@@@
@.@@.....@@@@@@@@@@@
@..@.@.@@@@@@@@@@@@@
..@.@@@@@@@@@@@@@@@@
@....@@@@@@@@@@@@@@@
..@.@@@@@@@@@@@@@@@@
.@.@@@@@@@@@@@@@@@@@
....@@@@@@@@@@@@@@@@
.@@.@@@@@@@@@@@@@@@@
@....@@@@@@@@@@@@@@@
.@.@@@@@@@@@@@@@@@@@
....@@@@@@@@@@@@@@@@
.@.@@@@@@@@@@@@@@@@@
.@@@@@@@@@@@@@@@@@@@
.@@@@@@@@@@@@@@@@@@@
13
2 12 0
18 2 0
4 9 0
16 1 0
2 16 0
12 4 0
0 10 0
1 12 0
14 2 0
2 5 0
1 8 0
4 14 0
1 9 0

6 4 0
2 9 0
1 9 0
2 11 0
1 3 0
7 3 0
18 1 0
11 1 0
2 12 0
1 6 0
4 0 0
5 3 0
0 16 0
