width 20
height 20
...@@..@...@@@@@@@@@
@.@.@.@.@.@.@.@@@.@@
@.............@@..@@
.@.@.@.@.@@.@@@.@.@@
.@..@@@@.@.........@
.@.@@@..@.@.@.@.@.@@
..@@...@..@@@@@.@@@@
.@@@@.@.@.@.@...@@@@
...@.........@@...@@
@.@@@.@@.@.@@...@.@@
...@@..@@@.@@@@.@@@@
@@....@.@@@@@@....@@
@@@@@....@@@@@@@.@@@
@@.@.@@.@@@.......@@
@@......@@..@@.@.@.@
@..@.@.@@.@.@@@.....
..@@@.@....@.@.@@.@@
@.@.@...@.@@........
......@..@.@@.@.@.@@
@@@.@..@.......@..@@
13
0 3 0
13 17 0
4 15 0
6 15 0
11 8 0
10 2 0
7 17 0
8 9 0
12 17 0
8 2 0
2 11 0
6 3 0
9 6 0

15 17 0
0 7 0
5 14 0
3 1 0
6 3 0
9 0 0
10 16 0
7 12 0
0 10 0
3 2 0
18 17 0
16 15 0
1 18 0
