width 20
height 20
@@@@@@@@@@@@@@.@.@@@
@@@@@@@@@@@@@......@
@@@@@@@@@@@@.@@@.@@@
@@@@@@@@@.@@......@@
@@@@@@@@...@.@.@.@.@
@@@@@@@@@.@.@@@@....
@@@@@@@@....@@@@@.@.
@@@@@@@..@@....@@@..
@@@@@@@@.@.@.@..@..@
@@@@@@@@@...@..@.@.@
@@@@@@@@@@.@.@.@....
@@@@@@@@@........@@.
@@@@@@@...@.@@.@.@..
@@@@@@@@@.@@..@@.@@.
@@@@@@@@.....@@...@@
@@@@@@@@@.@.@...@...
@@@@@@@@@@@..@.@@.@.
@@@@@@@@@...@@..@@..
@@@@@@@@@.@..@.@@@.@
@@@@@@@@@@@@@@@@@@@@
13
17 14 0
18 7 0
17 16 0
12 7 0
17 10 0
11 15 0
15 14 0
16 3 0
19 17 0
11 14 0
11 18 0
14 10 0
18 1 0

11 14 0
16 9 0
18 7 0
13 13 0
14 4 0
9 4 0
17 15 0
15 15 0
14 17 0
8 12 0
18 4 0
17 14 0
9 6 0
