width 20
height 20
@@@@@@@@@@@@@@@.@.@.
@@@@@@@@@@@@@@......
@@@@@@@@@@@@..@.@.@.
@@@@@@@@@@@@@....@..
@@@@@@@@@@@@@@.@@.@.
@@@@@@@@@@@@...@....
@@@@@@@@@@@@@@..@@.@
@@@@@@@@@@@.@.@.@..@
@@@@@@@@@@.......@@@
@@@@@@@@@@.@@@@.@.@@
@@@@@@@@@@@@.@.....@
@@@@@@@@@@@....@.@..
@@@@@@@@@@@@@@@.@.@.
@@@@@@@@@@@@@@@.....
@@@@@@@@@@@@@@@@.@.@
@@@@@@@@@@@@@@@@@@..
@@@@@@@@@@@@@@@....@
@@@@@@@@@@@@@@@@@@..
@@@@@@@@@@@@@@@@@@@@
@@@@@@@@@@@@@@@@@@@@
13
15 0 0
18 6 0
18 3 0
17 16 0
17 10 0
16 11 0
18 13 0
19 2 0
19 3 0
19 4 0
19 13 0
13 5 0
18 11 0

17 1 0
19 3 0
15 9 0
14 10 0
19 11 0
18 6 0
19 1 0
19 13 0
16 13 0
15 16 0
19 5 0
14 6 0
16 16 0
