width 20
height 20
....................
..........@........@
....................
....@...............
@....@@.........@...
@@...@@.@..@.....@..
@...................
@@.....@......@.....
@......@..........@.
...........@...@.@..
.....@...@..@......@
...................@
....@...............
..@..........@......
........@..@...@....
...@.....@..........
......@.@.....@...@.
.................@..
...@...@............
....................
9
3 17 0
1 10 0
12 9 0
9 12 0
1 14 0
12 2 0
13 10 0
4 19 0
15 12 0

15 0 0
11 16 0
16 0 0
11 18 0
17 16 0
2 12 0
13 0 0
4 18 0
16 10 0
