width 20
height 20
..@................@
@...@...............
.....@...@.....@....
...........@........
.....@.......@......
....................
.....@......@...@.@.
...................@
...................@
@......@............
......@....@...@....
....................
.....@......@....@..
.@..@...............
.......@............
....................
...........@........
.......@..@@...@.@..
...........@........
...........@........
9
6 14 0
9 1 0
19 12 0
10 13 0
19 19 0
5 7 0
7 0 0
17 2 0
3 16 0

6 14 0
1 19 0
17 15 0
9 12 0
19 17 0
11 5 0
15 18 0
17 2 0
19 18 0
