width 20
height 20
...............@@.@@
....................
....@.....@.........
......@......@.....@
...............@.@.@
...@...@.....@.....@
..@.................
................@..@
....@.@...@........@
....................
............@...@...
.@........@.........
.............@....@@
.....@..............
...@...@..@.........
....................
.........@........@.
....................
.........@@.......@@
.........@@....@...@
9
6 4 0
7 17 0
4 15 0
6 17 0
7 13 0
19 2 0
7 8 0
13 2 0
11 18 0

1 18 0
4 15 0
4 17 0
17 1 0
1 16 0
18 10 0
5 15 0
12 1 0
10 9 0
