width 20
height 20
....@.....@@@@@@....
.............@@@....
@...................
@...................
....@..@...@........
...@.............@..
......@......@......
...@.@...@..........
....................
...............@..@.
............@.......
.........@......@..@
.@.@........@.......
....................
.....@.............@
.........@...@......
................@...
..@..@..............
...............@....
.......@............
9
11 14 0
9 6 0
4 13 0
17 0 0
12 11 0
17 15 0
2 3 0
12 19 0
6 5 0

1 0 0
1 15 0
7 15 0
1 18 0
17 4 0
18 1 0
17 9 0
13 3 0
10 6 0
