width 20
height 20
....................
....................
.............@......
....@....@..........
.............@......
........@...........
....................
...@.......@.......@
........@....@.....@
................@..@
...................@
.....@..@....@.@....
@@..................
............@.......
.@....@.............
.@.............@....
.........@..........
..@..@.......@.@.@..
@...............@...
....................
9
10 6 0
13 6 0
9 7 0
10 3 0
15 9 0
3 12 0
4 6 0
0 1 0
16 1 0

7 5 0
11 19 0
0 14 0
0 5 0
0 0 0
18 1 0
9 15 0
17 0 0
17 2 0
