width 20
height 20
....................
.......@....@.......
....................
................@...
...@...@............
..@.................
.......@.@..@.......
.............@......
@.@.................
@.....@.@...........
@..@@......@.....@..
....................
.@......@.@.........
..@...@.............
....................
..........@...@.....
..@.@...@....@...@..
.......@.........@..
....................
..........@...@@...@
4
12 19 0
14 17 0
5 7 1
3 17 2

0 0 0
3 15 0
7 7 1
3 17 2
