width 20
height 20
@...........@@......
....................
....@...@..@........
....................
......@........@....
..@..@..............
.........@@@........
........@@@...@.@...
........@@..........
.......@@@..........
..............@.....
@...................
.......@.@..@.......
....@.........@.....
...@......@.........
....................
....................
..........@......@..
............@.......
...................@
4
1 6 0
17 2 0
16 9 1
7 5 2

10 10 0
5 2 0
11 15 1
16 13 2
