width 20
height 20
...@................
....................
.......@.........@..
....................
............@.......
....................
........@...........
..@....@......@.....
............@.......
..........@.........
.......@.........@..
...@.....@..........
...............@....
...@..@.............
.....@.@........@...
.........@..........
..........@.@.@.....
.@..................
....................
....@.......@....@@@
4
2 10 0
15 14 0
2 0 1
2 18 2

18 7 0
1 1 0
14 12 1
3 12 2
