width 20
height 20
.....@........@@....
.....@..............
.............@..@...
...............@..@.
....................
.........@..........
.........@..........
.............@.@.@..
.........@..........
..@.................
..............@.....
............@...@...
......@.........@...
@.........@.........
@...................
..@.@.......@.......
..@.................
......@..@..@...@@..
.....@.@............
....................
4
3 19 0
12 9 0
14 13 1
5 15 2

3 2 0
0 17 0
6 10 1
17 0 2
