width 20
height 20
......@.@...@@@.@.@.
.@@.@....@.@..@.....
@@@..@.@....@...@@.@
@@@.@..@.@.@..@...@@
@@@.@.@...@@@..@.@@@
@.@@.@@.@@.@.@..@@@@
..@..@.........@@@@@
.@@@...@.@@@.@.@@@@@
.@@@.@.@@@.@@@.@@@@@
..@@..@@........@@@@
.@.@@..@.@.@@@.@..@@
.....@.@..@@..@@@..@
@@.@@@@..@.@.@.@.@..
....@@@@...........@
@.@.@.@..@.@@.@.@.@@
@..@..@.@...@@@@@@@@
@.@@@....@.@@@@@@@@@
......@.@@.@@@@@@@@@
.@@.@..@@@@@@@@@@@@@
.@@..@.@@@@@@@@@@@@@
2
17 13 0
4 6 0

3 0 0
0 10 0
