width 20
height 20
@..@@.....@.@@@@@@@@
.@.@@@@@@.@.@@@@@@@@
.......@.....@.@@@@@
@.@@@@...@.@.@..@@@@
@@..@..@..@@...@@@@@
@@.@..@@@@...@.@.@@@
@....@.@.@@.@@...@@@
.@.@@@...@@.@.@@@@@.
.......@..@.........
.@.@.@@..@@.@.@@.@@.
@..@@@.@.@@..@...@@@
..@@@@.@..@.@@@.@.@.
.@@.@....@@@.@....@.
..@.@.@@.@@@.@.@@.@.
.@...@..@.@...@.....
@.@.@.@.@.@@.@.@.@.@
@.................@.
..@@@@.@.@@.@.@@.@@.
@.@@@@@....@...@.@..
...@@@@@.@.@.@.@...@
2
10 2 0
18 19 0

18 14 0
16 19 0
