width 20
height 20
@.@.@.@.@@@@@@@...@@
@........@@@@@.@.@@@
..@.@@.@..@.@.....@@
@..@@@@@@.....@@@@@@
.@..@@@@@@@.@...@@@@
...@.@@@@....@.@@@@@
.@....@..@@.@@@@@@@@
@..@@@@@.....@@@@@@@
@@@.@.@..@.@@@@@@@@@
........@..@@@@@@@@@
.@.@.@.@@.@@@@@@@@@@
..@@@..@@@@@@@@@@@@@
@..@@@.@@@@@@@@@@@@@
.@...@@@@@@@@@@@@@@@
...@@@@@@@@@@@@@@@@@
@@@@@@@@@@@@@@@@@@@@
@@@@@@@@@@@@@@@@@@@@
@@@@@@@@@@@@@@@@@@@@
@@@@@@@@@@@@@@@@@@@@
@@@@@@@@@@@@@@@@@@@@
2
4 10 0
0 4 0

8 8 0
6 1 0
