width 20
height 20
..@@@@@@@@@@@@@@@@@@
.@..@@.@@@@@@@@@@@@@
...@@@..@@@@@@@@@@@@
.@..@..@@@@@@@@@@@@@
@..@.@.@.@@@@@@@@@@@
.@.@......@@@@@@@@@@
.@...@.@@.@@@@@@@@@@
...@..@@@@@@@@@@@@@@
.@..@.@@@@@@@@@@@@@@
..@.@.@@@@@@@@@@@@@@
.@@@@.@@@@@@@@@@@@@@
..@.@@@@@@@@@@@@@@@@
.@@..@@@@@@@@@@@@@@@
....@@@@@@@@@@@@@@@@
@.@.@@@@@@@@@@@@@@@@
...@@@@@@@@@@@@@@@@@
@.@@@@@@@@@@@@@@@@@@
..@@@@@@@@@@@@@@@@@@
.@@@@@@@@@@@@@@@@@@@
.@@@@@@@@@@@@@@@@@@@
2
0 1 0
1 7 0

1 0 0
2 7 0
