width 20
height 20
....................
.......@............
.....@..........@...
.....@...@..@.......
....................
.@.............@....
..................@@
............@..@....
....@...@..@.@......
@.@.................
.....@...........@..
@...............@...
...@.@.....@..@.....
....................
.......@..@.........
.............@......
....@....@..........
...........@........
....................
.......@......@@@@..
10
6 13 0
17 18 0
0 2 0
8 19 0
8 4 0
9 2 0
7 12 0
8 11 0
17 0 0
4 3 0

16 4 0
0 4 0
14 14 0
19 3 0
10 4 0
18 12 0
11 6 0
8 11 0
15 1 0
17 13 0
