width 20
height 20
.@@.@@@@@.@.@.@@....
.....@@..........@.@
@@@.@.@.@.@.@.@@@...
.......@..@@@@.@@.@@
.@.@.@.@.@@.@.......
..@@@..@.....@.@.@@.
.@.@@@.@.@.@..@.@.@@
....@@@@@...@...@.@@
.@.@.@.@.@.@@.@.....
@..........@.@@@.@.@
@@.@.@.@@.@@.@@@@..@
@...@@@@@@@..@@@..@@
@.@....@@@@.@.@@@.@@
@@@@.@..@...........
@@@..@.@@@.@.@.@.@@.
@@@@.@@@@...@@@@@@@.
@@@@.@@@..@..@@@@@..
@@@..@..@..@..@@@@@.
@@@@...@..@.@@..@@@.
@@...@@@@......@@@@.
13
4 16 0
0 1 0
13 8 0
16 8 0
9 19 0
6 10 1
8 8 1
5 2 1
10 14 1
3 11 2
13 2 2
16 14 2
7 9 2

4 17 0
3 3 0
17 8 0
3 19 0
10 5 0
13 12 1
8 16 1
14 18 1
5 9 1
9 18 2
5 5 2
2 3 2
0 5 2
