width 20
height 20
@@@@@@@@@@@@@@@@@@@@
@@@@@@@@@@@@@@@@@@@@
@@@@@@@@@@@@@@@@@@@@
@@@@@@@@@@@@.@@@@@@@
@@@@@@@@@@@@.@@@@@@@
@@@@@@@@@@@..@@@@@@@
@@@@@@@@@@@@.@@@@@@@
@@@@@@@@@@.....@@@@@
@@@@@@@@..@.@.@@@@@@
@@@@@@@@@....@@@@@@@
..@@@@@.@.@.@.@@@@@@
.@.@@@....@....@@@@@
......@.@@@@.@..@@@@
@@@.@.@.@.@.@.@@..@@
@@@@........@.@.@.@@
@@@@@.@.@.@...@.@..@
@@....@..@@@@.....@@
@@@.@.@.@@@@.@@.@.@@
@....@@@@@@......@@@
@@@.@@@@@@@@.@@.@@@@
13
5 17 0
12 7 0
13 10 0
7 10 0
0 11 0
11 7 1
0 12 1
9 9 1
4 18 1
13 11 2
5 16 2
13 16 2
5 15 2

3 16 0
16 13 0
12 11 0
3 18 0
0 10 0
3 12 1
0 12 1
7 11 1
17 14 1
13 11 2
3 19 2
12 7 2
13 10 2
