width 20
height 20
@@@@@@@..@.@......@.
@@@@@@@@.....@@@@.@.
@@@@@@...@.@.@..@@..
@@@@...@..@@.@.@..@.
@@@@@.@@@.@..@.@.@@.
@@@@@@@...@@.@...@..
@@@@@@@@@.@...@@..@.
@@@@@@...@.@.@.@.@..
@@.@@..@@....@.....@
@@...@.@@.@@...@.@.@
@@.@....@@...@..@...
@@@..@.@.@.@@@@@.@.@
@@@@.@...@.@.@.@....
@@@@@.@.@@@....@.@@@
@@@@........@@......
@@@@@.@.@.@@@@.@.@.@
@@@@@@@@@.@@@@@.@...
@@@@@@@@@@@@@@@.@@.@
@@@@@@@@@@@@@@@.....
@@@@@@@@@@@@@@@@.@.@
13
6 12 0
9 1 0
9 6 0
19 4 0
8 0 0
19 7 1
17 0 1
14 4 1
14 8 1
4 3 2
10 7 2
6 9 2
7 10 2

18 10 0
17 16 0
16 15 0
19 0 0
8 12 0
14 12 1
17 0 1
2 9 1
14 8 1
14 4 2
16 0 2
14 13 2
6 3 2
