width 20
height 20
@@@@@@@@@@@@@..@@@@@
@@@@@@@@@@@@@.@@.@@@
@@@@@@@@@@@@@.@..@.@
@@@@@@@@@@@....@...@
.@@@@@@.@@.@.@..@@..
....@.......@@@....@
.@@@@@@.@@@.@@@@@@..
.@@@@@@@@@@.@@.@.@.@
..@@@@@@.@.........@
@....@.@.@.@@.@.@.@@
@@.@.@.....@.@.@..@@
...@.@@@@@.@....@..@
.@.@@@@......@.@@@@@
@@.@@...@@.@..@.@.@@
.@....@...@@@@..@.@@
...@@..@@.@@...@..@@
.@...@@...@.@.@.@.@@
.@@.@@@.@...........
.@@.@@@@@@.@.@.@@.@.
...@@@@@@@..@@...@..
13
7 4 0
12 15 0
10 18 0
18 3 0
12 8 0
17 3 1
13 16 1
18 8 1
3 14 1
10 17 2
11 5 2
9 15 2
0 17 2

7 5 0
15 4 0
16 8 0
11 16 0
2 14 0
4 11 1
15 14 1
13 16 1
7 12 1
18 5 2
10 4 2
14 8 2
16 3 2
