width 20
height 20
@..@...@...@@..@@..@
.@.@@@.@.@@@.@.@.@..
..........@....@.@.@
@@.@.@.@@..@.@...@.@
@.@@@@@..@....@@@...
........@@.@.@.@.@.@
@.@.@.@.@.@.........
...@@@.....@@@.@.@.@
@@..@@@.@.@.@...@...
@@.@.@..@....@.@.@.@
@@@....@.@.@@@....@@
@@@@.@...@@..@.@.@@@
.@@@@@@@..@.@..@..@.
..@@@@...@...@..@.@.
.@.@@.@.@@@.@..@....
.............@@.@.@.
.@.@.@.@@.@@.@....@@
..@@@@@@.@.@@.@.@.@@
.@.@.@.@........@@.@
.........@.@@.@.....
8
7 13 0
12 3 0
7 5 0
15 18 1
15 8 1
14 6 1
5 14 2
3 10 2

6 9 0
9 8 0
2 14 0
9 6 1
7 7 1
9 2 1
13 4 2
2 5 2
