width 20
height 20
..@@@@..@...@@@@..@@
.@.@.@.@.@.@.@@@.@@@
..................@.
.@@.@.@.@.@@.@.@@...
..@..@@@@@@..@@...@.
.@.@@@@.@.@@...@.@.@
..........@@@@@....@
@.@.@.@.@@.@...@.@..
.@@..@.......@@.@.@.
....@.@.@.@.@@@...@.
@.@.@.@@..@@@@..@...
...@...@.@@.@.@..@.@
.@...@.@.@......@@@.
..@.@.@.@.@.@@.@.@..
.@@@........@@.....@
..@@@.@.@@.@...@@@.@
.@.@..@@@.@@@@.@@@@@
@....@..@..@@@.@.@.@
@.@.@..@@.@.@@......
...@@@.........@@.@.
8
17 10 0
2 9 0
11 14 0
9 0 1
6 12 1
2 6 1
8 12 2
8 11 2

16 9 0
9 9 0
13 11 0
4 6 1
17 9 1
13 2 1
15 10 2
0 12 2
