width 20
height 20
@@@@@@@@@@@@@@@..@@@
@@@@@@@@@@@@@@.@..@.
@@@@@@@..@@@@....@..
@@@@@@@.@.@@.@.@@.@.
@@@@@@..............
@@@@@.@.@@.@.@.@.@.@
@@@@@.@@....@...@...
@.@...@.@@.@@@.@@@.@
....@...@@@..@..@@..
@@.@..@@.@.@.@.@...@
@.@.@......@..@.@@..
@.@...@@.@...@.....@
....@...@@@@..@.@.@@
@.@..@.@@@@@@.@.@@.@
...@@.@@@@@@........
@.@@..@@@@@@@.@@.@.@
@.@.@.@@@@@@.@....@@
.......@@@@....@@@@@
@.@.@.@@@@@@.@.@@@@@
..@@...@@@@@@@@@@@@@
8
7 4 0
8 10 0
9 6 0
16 14 1
13 6 1
5 7 1
5 10 2
15 13 2

14 17 0
17 1 0
10 4 0
14 14 1
12 18 1
5 7 1
1 14 2
18 4 2
