width 20
height 20
@@@@@@@@@@.........@
@@@@@@@@@@.@@.@@.@..
@@@@@.@.@.@.@.@@@..@
@@.@.........@.@.@..
@....@.@.@.@.@.....@
..@.@.@@@.@@...@.@..
.@..@..@.....@.@@..@
..@...@@@.@.@@.@@.@@
@.@.@.@@@@@.@@@@..@@
@@...@.@@@.@.@@.@.@@
@.@.@...@........@..
......@..@.@.@@.@@.@
@.@.@@.@@@@@@.......
@@......@@...@@.@.@.
@..@.@.@@.@.@@@@...@
@@.@.@.@.....@@@@.@@
@...@.@.@.@.@...@..@
@.@@.......@.@.@..@@
.....@@.@@.......@@@
.@.@.@....@@@.@.@@@@
8
18 6 0
6 14 0
13 10 0
4 15 1
14 18 1
11 10 1
6 19 2
7 18 2

17 16 0
7 13 0
2 14 0
10 10 1
16 4 1
15 10 1
3 16 2
11 8 2
