width 20
height 20
@.@@@.@.@.@....@@.@.
...@........@.@@....
@.@.@.@.@.@@@@@@@.@.
@.@....@@@@@@@@@@.@.
....@.@.@..@@@@@..@.
.@.@......@@@@@..@..
.@@@@.@.@...@@.@@.@.
.@.@.@.@.@@.@.......
@.............@@.@.@
..@.@.@.@@.@@@@@@..@
.@.@.@..@.....@@.@.@
...@..@@@@.@.@@@....
.@.@@.@.@.@.@.@@@.@@
.@............@@..@@
.@@.@.@.@@.@@..@@@.@
.@.@...@...@.@.@.@..
....@.@..@.@...@.@.@
.@.@..@@..@.@@......
@...@...@....@@.@.@.
@@.@..@@..@.@@@@...@
8
0 17 0
9 18 0
15 7 0
7 0 1
11 17 1
11 6 1
4 15 2
7 2 2

0 5 0
7 5 0
14 7 0
16 17 1
8 8 1
11 6 1
10 1 2
18 16 2
