width 20
height 20
@@@.@..@..@@@....@@@
@.....@@.@.@.@@.@@@@
..@.@@..........@@.@
@..@@.@@.@.@.@@.@@.@
@@.....@@@@....@.@.@
@@.@@@..@.@@.@......
@.@....@......@.@@.@
....@@@..@.@.@@@@@@.
@.@@.@.@..@@..@.@@@.
.........@..@@...@..
.@.@.@.@.@@.@.@.@.@.
@...@@@.@...........
@@.@.@..@@.@@@@.@@.@
@....@@.@.@.@.@@@...
.@.@........@.@.@@.@
..@..@@.@.@.........
@.@@@@.@@@@.@.@@.@@.
@....@.@@...@@@....@
..@@@.....@..@.@.@@@
@.....@.@.@.@@......
6
11 4 0
9 0 0
1 18 1
13 13 1
12 6 2
8 1 2

10 9 0
5 14 0
16 4 1
1 3 1
18 9 2
4 17 2
