width 20
height 20
@...@@@@@@@@@@@@@@@@
@.@@@@@@@@@@@@@@@@@@
...@@@@@@@@@@@@@@@@@
.@.@@@@@@@@@@@@@@@@@
..@@@@@@@@@@@@@@@@@@
.@@.@.@@@@@@@@@@@@@@
.@@....@@@@@@@@@@@@@
.@.@@.@.@@@@@@@@@@@@
...@........@@@.@@@@
.@..@@.@.@.@@.@.@@@@
@..@...@@.......@@@@
@@..@@...@.@@@@.@@@@
@..@@@@@@@@@......@@
@.@@@@..@.@.@.@.@@@@
....@@@........@@@@@
@@.@@@..@.@@@.@@@@@@
...@.@@..@@@@@@@@@@@
.@......@@@@@@@@@@@@
..@.@.@.@@@@@@@@@@@@
.@@@...@@@@@@@@@@@@@
6
1 4 0
2 9 0
15 13 1
7 11 1
0 18 2
0 5 2

13 12 0
11 8 0
1 0 1
2 11 1
11 10 2
15 11 2
