width 20
height 20
@@@@@.....@@..@@@@@@
@...@@.@@..@.@@@@@@@
@@@..@@.@.@@..@@@@@@
@..@.@.......@.@@@@@
@@...@.@.@.@....@@@@
@..@.@..@@..@.@.@@@@
@@..@@.@@.@.@@@@.@@@
...@...@...@..@...@.
@@.@.@@.@@.@@..@@...
..............@@.@@.
.@.@.@@@.@@@@.......
..@@@@@@@@@@@.@@@.@.
.@@@@@@@@@@@@@@@@.@@
..@@@@@@@@@@@@@@@...
.@@@@@@@@@@@@@@@@.@@
@@@@@@@@@@@@@@@@@.@@
@@@@@@@@@@@@@@@@@@@@
@@@@@@@@@@@@@@@@@@@@
@@@@@@@@@@@@@@@@@@@@
@@@@@@@@@@@@@@@@@@@@
8
5 0 0
13 5 0
0 11 0
3 4 1
5 9 1
13 0 1
1 5 2
9 1 2

2 9 0
16 6 0
12 9 0
12 7 1
6 4 1
13 5 1
9 9 2
2 7 2
