width 20
height 20
....@.@@.@.@@@@@.@@@
@@@...@.....@@@....@
.@.@@...@.@..@.@@.@@
......@.@..@.......@
.@.@.@@.@.@@.@.@.@@@
..@....@..@@@@@..@.@
.@.@@.@@@..@.@@.@...
.....@@@..@..@.@.@.@
@@@.@@@@@...@@......
..@...@@@@@.@.@.@@.@
@...@..@@@..@...@.@@
@@.@..@@@@@...@.....
.@.@@.@@@@@@@@@@@.@.
..@.........@@@@@@..
@.@@@.@.@.@.@@@@@@@.
.......@@@...@@@@@@.
.@@@@.@@@@@.@@@@@@@@
@@@@@.@@@@@..@@@@@@@
@@@@@@@@@@@@@@@@@@@@
@@@@@@@@@@@@@@@@@@@@
8
2 10 0
0 9 0
19 11 0
12 15 1
5 12 1
11 11 1
0 16 2
17 3 2

6 5 0
0 9 0
15 8 0
2 12 1
9 2 1
11 14 1
2 3 2
1 14 2
