width 20
height 20
@@@..@..............
@@.@.@@.@.@.@@@@@.@.
@@.......@.@.@@..@..
@@@@@.@.@@......@@.@
@@...@.....@.@.@....
@@@@..@.@.@...@@@.@@
.@.@.@@@...@@@@@....
......@@@.@..@@.@.@@
.@@.@@@@@@@@........
.@@@@.@@@@@@@.@@.@.@
.@@.@..@@@@@@...@@@@
......@.@@@@@@.@@@@@
@@@@@...@.@.@...@@@@
@@@@@.@......@.@@@@@
@@@@...@@.@.@..@@@@@
@@@@@@@@@@....@@@@@@
@@@@@@.@@@@.@.@@@@@@
@@@@@..@@.@..@@@@@@@
@@@@@@.....@.@@@@@@@
@@@@@@@@.@...@@@@@@@
8
6 17 0
8 19 0
14 13 0
8 0 1
4 1 1
16 9 1
9 18 2
0 6 2

4 6 0
6 4 0
18 4 0
7 2 1
13 15 1
5 5 1
17 4 2
17 0 2
