width 20
height 20
@@................@.
@@..................
@@.......@..........
...@..@......@......
.................@..
.@..................
........@......@....
@.............@.....
.....@....@.........
.@............@@....
...@...@..@...@.....
............@.......
.......@............
........@.@..@......
.......@........@...
.@..@....@...@......
................@...
..@..............@..
...@................
..................@@
16
12 5 0
17 13 0
12 15 0
0 8 0
6 17 0
1 19 0
9 12 1
3 16 1
13 16 1
2 8 1
19 14 1
18 17 2
9 7 2
9 19 2
2 11 2
0 11 2

6 6 0
3 0 0
16 9 0
11 1 0
18 3 0
18 17 0
14 0 1
9 13 1
4 4 1
9 5 1
6 11 1
8 7 2
5 1 2
9 12 2
6 0 2
17 1 2
