width 20
height 20
......@.@.@@...@..@.
...............@....
....................
..........@.........
....@.....@...@...@.
..@......@.@....@...
.......@.....@......
.@.@................
....@......@.....@..
..........@.........
........@..@......@.
....@........@......
.....@....@....@.@..
......@....@........
...@................
.........@..@.@...@.
...@......@..@......
....................
.....@.......@..@...
.............@@.....
13
0 15 0
19 5 0
8 6 0
19 2 0
10 17 0
8 16 0
19 17 0
16 7 0
16 13 0
3 5 0
6 4 0
6 14 0
18 5 0

16 13 0
19 0 0
1 18 0
11 7 0
11 17 0
6 19 0
17 16 0
18 9 0
11 3 0
6 15 0
16 19 0
5 5 0
1 15 0
