width 20
height 20
....................
.@............@.....
........@....@......
....@...............
...@.@..............
.........@.......@..
...............@....
...@.@..@....@...@..
..........@...@....@
..@...@.............
.........@..........
....................
.....@.......@...@..
.@...........@.....@
...............@...@
.........@.........@
.......@...@.......@
...@...............@
...........@.......@
........@.....@....@
13
3 16 0
1 19 0
10 3 0
11 14 0
19 2 0
5 19 0
0 16 0
7 11 0
13 0 0
15 11 0
14 14 0
3 1 0
13 16 0

15 18 0
2 17 0
10 0 0
0 2 0
0 18 0
9 19 0
1 17 0
7 11 0
1 9 0
0 9 0
11 5 0
3 1 0
1 0 0
