width 20
height 20
.@@@@@@@.@.@@@.@@@@@
..@@@@@.....@@....@@
.@.@@..@.@.@...@.@@@
......@.@....@..@@@@
@.@.@.....@@.@.@@@@@
..@@@.@.@.@...@@@@@@
.@.@@..@@.@.@.@@@@@@
@@.@@@.@@@...@.@.@..
....@.@.@.@.@......@
@.@@.........@.@@.@.
..@..@@@@@.@@.@.....
@...@@@.@.@.@...@.@.
..@.@.........@..@@@
@@..@.@.@@.@@..@....
...@...@..@@.@@@@.@@
@@.@@.@@@.@@.@@@....
................@.@.
@.@.@.@.@.@.@.@@@@@@
@..@...@@.@@..@..@@@
..@@@.@....@@...@@@@
5
19 13 0
0 3 0
11 3 1
1 11 1
14 2 2

9 6 0
2 14 0
16 18 1
19 15 1
19 13 2
