width 20
height 20
......@@..@@@@@@.@.@
@.@@@.@.@.@@@@@.....
@..@.......@@@@@.@@@
@.@.@.@.@.@...@...@.
....@@.@.@.@.@.@.@..
@.@................@
.@.@@@.@@.@.@.@.@@..
...@.....@.@.@@@..@.
.@.@.@.@.@.@.@@..@..
..@.@.@.........@.@.
.@@.....@@.@.@.@@...
.@.@@.@@@@@.@...@.@@
...@.@.@@@...@.@...@
.@........@.@.@.@.@@
.@.@@@.@@...........
@.@@@.@@@@.@.@.@.@.@
...@...@@@@@@@@...@@
.@@.@.@.@@.@.@.@.@.@
.@..................
...@@.@.@@.@.@.@.@.@
5
6 12 0
5 9 0
19 8 1
16 14 1
12 17 2

6 6 0
18 12 0
15 9 1
1 3 1
17 1 2
