width 20
height 20
@@@@@@@.....@.....@.
@@@@@@@@.@.@@.@.@...
@@@@@@@@@....@.@.@.@
@@@@@@@@@@.@........
@.@@@@@@@@@..@@@.@.@
@..@.@.@.@..@@@@@...
@.@.......@..@.@@@.@
..@@@.@.@...@@..@@..
@.@.@@.@..@@@..@...@
@.......@..@@@...@.@
..@.@.@...@@@..@..@@
.@.@@@..@.@@.@.@.@.@
.@..@..@..@...@.....
@@.@.@@.@@@@@.@@@@.@
..........@.........
.@@.@.@.@.@@.@.@.@.@
@@@@.@..@..@.@@@@.@@
@@@....@..@@....@...
@@@@.@@.@.@@.@@...@.
@@@@@.........@.@@..
5
5 19 0
8 17 0
17 8 1
10 0 1
16 14 2

4 5 0
1 7 0
18 19 1
13 14 1
2 9 2
