width 20
height 20
@@@@@@@..@@@@@@@@@@@
@@@@@@..@@@@@@@@@@@@
@@@@@@@.@@@@@@@@@@@@
@@@@@@...@@@@@@@@@@@
@@@@@@.@@@@@@@@@@@@@
@@@@@@..@@@@@@@@@@@@
@@@@@@.@.@@@@@@@@@@@
@@@.@..@.@@@@@@@@@@@
@@@..@.@..@@@@@@@@@@
@@.@.....@@@@@@@@@@@
@....@.@.@@.@@@@@@@@
.@.@@.@@@.@.@@@@@@@@
.............@@@@@@@
@.@@.@.@.@@@..@@@@@@
....@...@@...@@@@@@@
@.@@.@.@@..@.@@@@@@.
...@...@@.@..@@@@...
@.@.@@..@@@@.....@.@
.....@.@@@@@@.@@....
@.@.@@@@@@@@..@..@.@
1
4 15 0

0 12 0
