width 20
height 20
@@@@@@@@@@@..@@@.@.@
.@@@@@@@@@@@..@..@.@
..@@@@@@@@.@.@.@.@..
@...@@@@@..........@
..@.@@@@..@@@.@.@.@@
@@...@@.@..@..@.@@.@
@@@.@@....@@.@@@@...
@@@...@.@@..@.@@@@.@
@@..@...@.@........@
@.@@.@@...@.@.@.@@..
...@....@...@..@.@.@
@@...@@@..@@..@@....
@@.@@@@@@...@...@@.@
@@@@@@@@@@.@@.@@....
@@@@@@@@@@@@@@@@@@.@
@@@@@@@@@@@@@@@@@@@@
@@@@@@@@@@@@@@@@@@@@
@@@@@@@@@@@@@@@@@@@@
@@@@@@@@@@@@@@@@@@@@
@@@@@@@@@@@@@@@@@@@@
1
16 0 0

5 10 0
