width 20
height 20
@@@@@@@@@@......@@@@
@@@@@@@@@.@.@@.@@@@@
@@@@@@@.....@@@@@@@@
@@@@@@@@@.@..@@@@@@@
@@@@@@@@@@..@@@@@@@@
@@@@@@@@@@@.@@@@@@@@
@@@@.@@@@@@.@@@@@@@@
@@@..@@@@@@..@.@@@@@
@@@.@@@@@..@....@@@@
@@...@@@@@...@@@@@@@
@.@.@..@@@@@.@.@@.@@
@.....@.@@@.......@@
..@.@@...@@.@.@@.@@@
@.@@@@@@.@...@..@.@@
...@.@@...@.@@@.....
.@.@.@.@.@...@@.@.@.
@.........@@.@.@.@@.
@@@.@.@@.@.@........
@...@@.@.....@@@@.@.
@@@@@@...@@.@@@@@@@.
1
19 14 0

4 15 0
