width 20
height 20
@@@@@@@@@@@@@@@@@@@@
@@@@@@@@@@@@@@@@@@@@
@@@@@@@@@@@@@@@@@@@@
@@@@@@@@@@@@@.@@@@@@
@@@@@@.@.@.@..@@@@@@
@@@@@@...@...@@@.@.@
@@@@@@@@...@.@.....@
@@@@@@@.@@.@@..@@.@@
@@@@@........@.@@@@@
@@@@..@.@.@@...@..@@
@.@.@@@.@...@@...@.@
.........@.@@@.@....
@.@.@@.@@@@.@...@@.@
@..@@.@@.@...@@@@@@@
@@.........@..@@@@@@
@@@@@.@@.@.@.@@@@@@@
@@......@..@@@@@@@@@
@@@.@.@@..@@@@@@@@@@
@@@@...@@.@@@@@@@@@@
@@@@@.@@@.@@@@@@@@@@
1
5 19 0

10 5 0
