width 20
height 20
.@.@.@.@@@@@@@@@@@@@
.......@@@@@@@@@@@@@
.@@.@@.@@@@@@@@@@@@@
@@@...@@@@@@@@@@@@@@
.@@.@@.@@@@@@@@@@@@@
........@@@@@@@@@@@@
@.@.@.@.@@@@@@@@@@@@
.@...@@.@@@@@@@@@@@@
...@@..@@@@@@@@@@@@@
.@....@@.@@@@@@@@@@@
@..@@..@.@@@@@@@@@@@
..@...@..@@@@@@@@@@@
.@@.@...@@@@@@@@@@@@
@....@.@@@@@@@@@@@@@
..@@@@@@@@@@@@@@@@@@
@......@@@@@@@@@@@@@
@.@.@.@@@@@@@@@@@@@@
@.@.@....@@@@@@@@@@@
..@@@@.@@@@@@@@@@@@@
@...@...@@@@@@@@@@@@
16
5 9 0
6 19 0
6 1 0
1 1 0
6 0 0
7 6 0
3 6 0
4 9 0
5 16 0
1 19 0
0 4 0
2 9 0
2 1 0
8 10 0
1 17 0
5 1 0

1 13 0
0 18 0
3 4 0
8 10 0
3 15 0
8 9 0
2 7 0
1 15 0
4 5 0
1 19 0
7 19 0
6 8 0
7 17 0
2 10 0
2 9 0
6 17 0
