width 20
height 20
@@@@@@@@...@@@@@@.@.
@@@@@@@..@.@@@@@@.@.
@@@@@@@.@.@.@@@@....
@@@@@@@......@.@@.@.
@@@@@@@@.@@@.....@@.
@@@@@@@@@@@@.@.@....
@@@@@@@@@@@...@..@.@
@@@@@@@@@@@@.@@@.@@@
@@@@@@@@@@@...@@.@.@
@@@@@@@@@@..@...@...
@@@@@@@@@@@.@.@..@@.
@@@@@@.@@....@.@@.@.
@@@@@@.@.@.@........
@@@@@......@.@.@.@.@
@@@@@@@.@.@...@@@@..
@@.....@@..@.@@@@@@.
@@@@@@.@@@..@@@@@@@@
.@@.@...@.@.@@@@@@@@
.....@.@....@@@@@@@@
.@.@.....@.@@@@@@@@@
16
11 14 0
12 4 0
2 15 0
19 1 0
19 4 0
10 9 0
12 8 0
11 18 0
12 6 0
15 9 0
10 18 0
10 16 0
17 2 0
9 15 0
11 3 0
8 18 0

12 14 0
18 14 0
12 13 0
6 17 0
11 18 0
19 1 0
6 19 0
3 18 0
7 17 0
12 5 0
17 2 0
9 15 0
13 4 0
10 16 0
16 8 0
6 13 0
