width 20
height 20
@@@@@@@@@@@@@@@@@@@@
@@@.@@@@@@@@@@@@@@@@
.....@.@@@@@@@@@@@@@
@.@.@@..@@@@@@.@@@@@
@..@@..@@@@@@@..@@@@
.@.@@@.@@@@@@@.@.@@@
...@@@.@@@@@@@.@.@@@
@@.....@.@@.@....@.@
@@@.@.@.....@@.@....
@@@@..@.@.@@@@@.@.@@
@@@@@...@..@@@.....@
@@@...@@.@.@@@@.@.@@
@@@@.@.....@@@@.@@@@
@@@@@.@.@@........@@
@@.@@.@.@@@.@.@@.@.@
@.......@@@@@@......
@.@@.@@.@@@@@@@.@.@@
@...@..@@@@@@@@@@...
@.@@.@..@@@@@@@@@.@.
.......@@@@@@@@@@.@.
16
17 8 0
1 18 0
17 16 0
6 19 0
10 11 0
9 8 0
0 19 0
6 3 0
5 8 0
11 13 0
17 11 0
1 4 0
4 11 0
2 6 0
14 4 0
3 1 0

3 2 0
2 17 0
15 11 0
6 19 0
16 8 0
9 10 0
10 13 0
3 7 0
4 2 0
7 15 0
7 12 0
0 2 0
3 3 0
14 8 0
1 6 0
7 18 0
