width 20
height 20
@@@@@@...@@.....@@..
@@@@@..@@...@.@....@
@@@@.@..@.@.@@.@@.@@
@@@....@@@@@.@.....@
@@@@.@@@@......@.@@.
@@.....@@@.@@@.@@@..
@@@@.@@@@..@@.@@.@@.
@@@@...@@@.......@..
@@@@.@.@.@.@.@@.@@@.
@@@.@@......@@@..@..
@@@..@.@.@@....@@@@.
@@@@.@@..@@.@.@.@.@.
@@@@....@..@@.......
@@@@@.@@@@.@@.@@.@.@
@@@@@@@@@..@....@..@
@@@@@@@@@@..@.@..@.@
@@@@@.@@.@@.@@..@..@
@@@@@....@....@..@..
@@@@@@.@...@@...@..@
@@@@@...@.@...@..@.@
16
18 18 0
10 5 0
13 11 0
16 13 0
4 6 0
18 14 0
13 15 1
3 10 1
9 4 1
6 19 1
11 1 1
10 4 2
4 3 2
15 15 2
9 19 2
7 19 2

15 7 0
13 7 0
19 0 0
15 0 0
19 11 0
5 16 0
11 1 1
6 2 1
8 18 1
16 13 1
16 17 1
4 6 2
6 10 2
4 5 2
15 12 2
13 0 2
