width 20
height 20
...@........@@@@@@@@
.@..@@@@@.@.@@@@@@@@
..@@.@.@@@..@@@@@..@
.@@.....@..@@@@@.@.@
.@.@.@.@..@.@@@@....
....@..@@....@@@@@.@
.@@..@..@@@.@@@@.@.@
@@@.@.@.............
@@......@@@@.@@.@@.@
@@@.@.@...@@@....@..
@@@@.@..@.@@@.@@@@.@
@@@@.@@@..@.@@@@@..@
@@@......@....@@..@.
@@@.@@.@.@@.@.@.@...
@@@@....@....@@...@.
@@@@@@.@@@.@....@..@
@@@@@@@@@@@@@.@.@.@@
@@@@@@@@@@@@@@@@@@@@
@@@@@@@@@@@@@@@@@@@@
@@@@@@@@@@@@@@@@@@@@
16
6 14 0
16 4 0
5 14 0
17 2 0
16 7 0
18 13 0
3 1 1
6 8 1
6 3 1
4 11 1
9 9 1
7 10 2
8 11 2
18 7 2
14 15 2
10 12 2

6 12 0
3 6 0
10 0 0
0 1 0
14 7 0
18 6 0
8 9 1
12 14 1
9 5 1
10 14 1
10 5 1
19 13 2
12 12 2
18 13 2
0 5 2
11 11 2
