width 20
height 20
@@@@....@.@...@.@@.@
@@.@@.@@@...@@..@@.@
@.........@@@.@.....
@@.@.@@@.@.@....@.@.
@@.@.@@@@..@.@@@.@@.
@...@@@@@@.@.@.@.@.@
.@.@@@@@@...........
.@..@@@@@.@@.@.@.@.@
...@@@@@@@@..@.@@...
.@.....@@@.@@.@@@.@@
@@.@.@.........@...@
@.@@.@@@.@.@.@.@.@..
..@..@....@..@.@@..@
@...@..@.@.@..@..@..
@@@.@@.@@@.@.@.@.@.@
@@@@@@.....@........
@@@@@@@.@.@@.@@.@.@.
@@@@@@..@@@@@...@@@.
@@..@.@...@...@@@@@@
@@@.....@..@@...@@@@
16
13 3 0
16 2 0
13 0 0
12 6 0
12 12 0
17 6 0
14 6 1
18 14 1
13 17 1
0 9 1
16 14 1
12 18 2
7 2 2
8 13 2
9 0 2
8 2 2

13 0 0
13 18 0
7 10 0
12 4 0
12 7 0
11 0 0
4 2 1
9 1 1
5 0 1
9 6 1
16 13 1
13 19 2
4 12 2
8 12 2
8 2 2
6 9 2
