width 20
height 20
..@@.@@@@@@@@@@@@@@@
@.....@@@@@@@@@@@@@@
..@@.@.@@@@@@@@@@@@@
.@@@.....@@@@@@@@@@@
@@...@.@..@@@@@@@@@@
@.@.@@@..@@@@@@@@@@@
.....@@.@@@@@@@@@@@@
.@@@..@@@@@@@.@.@@@@
.@@@@@@@@@@@.....@@@
.@.@.@@@@@@@.@@.@@@@
......@@@@@@@@@..@@@
.@.@.@@@@@@@@@@.@@@@
.@@....@@@@.@@@..@@@
.@@@@@.......@.@..@@
@......@.@.@.....@@@
@@@@.@..@.@..@.@@@@@
@@@@@@.@@..@@...@@@@
@@@@....@.@@@@.@@@@@
@@@@@@.@...@...@@@@@
@@@@@@...@..@.@@@@@@
16
4 10 0
10 14 0
11 12 0
0 9 0
1 1 0
13 8 0
16 14 1
7 3 1
4 17 1
0 6 1
5 14 1
13 19 2
17 13 2
3 5 2
11 13 2
8 13 2

0 7 0
16 13 0
6 14 0
8 19 0
3 1 0
4 7 0
6 18 1
1 5 1
15 11 1
0 8 1
11 13 1
6 13 2
12 15 2
8 3 2
2 6 2
4 11 2
