width 20
height 20
@@@@@@@@@@@@@@@@@@@@
@@@@@@@@@@@@.@@@@@@@
@@@@@@@@@@@@..@@@@..
@@@@@@@@@@...@@@...@
@@@@@@@@@@@@.@@.@.@.
@@@@@@@@@@..........
@@@@@@@@@@@.@.@.@.@.
@@@@@@@@@@...@@@@.@.
@@@@@@@@@..@@@@@...@
@@@@@@@@@@..@@@.@@.@
@@@@@@@@@@.@@.......
@@@@@@@@@..@.@.@.@.@
@@@@@@@@.@@.....@...
@@@@@@....@@.@.@@@.@
@@@@@..@.@@@..@@....
@@@@@@.@.....@@@@@.@
@@@@@@..@@@.@@@@@@@@
@@@@@..@@@@@@@@@@@@@
@@@@.@..@@@@@@@@@@@@
@@@....@@@@@@@@@@@@@
16
8 14 0
12 14 0
5 14 0
18 12 0
11 16 0
9 13 0
16 8 1
8 13 1
17 14 1
18 15 1
16 5 1
4 19 2
6 15 2
3 19 2
7 13 2
11 12 2

4 18 0
12 15 0
6 15 0
13 5 0
9 11 0
7 18 0
8 13 1
12 7 1
11 9 1
18 14 1
12 4 1
12 12 2
14 10 2
9 15 2
9 13 2
10 9 2
