width 20
height 20
@@@@@@@@@@@@@@@@@@@@
@@@@@@@@@@@@@@@@@@@@
@@@@@@@@@@@@@@@@@@@@
@@@@@@@.@@@@@.@@@@@@
@@@@@@...@@@..@@@@@@
@@@@@@@.@@..@.@@@@@@
@@@@@...@..@...@@@@@
@@@@@@@..@.@.@..@@@@
@@@@@@..@.....@.@@@@
@@@@@..@.@.@.@@@@@@@
@@@.@@.@..@...@@@@@@
@@@..@.@.@.@.@@.@@@@
@@..@@.......@...@@@
@@@....@.@.@..@.@.@.
@@@@@.@..@@@@@......
@@@@@@..@@@.@.@@@.@.
@@@@@.@.@.....@..@..
@@@@@...@@@.@..@.@.@
@@@@.@@......@......
@@@.....@.@.@@@.@.@.
16
16 17 0
14 17 0
8 7 0
6 17 0
18 18 0
6 12 0
15 8 1
9 16 1
8 10 1
16 16 1
12 6 1
5 13 2
8 14 2
14 14 2
7 12 2
14 18 2

8 13 0
9 10 0
9 6 0
8 9 0
7 19 0
7 3 0
14 18 1
13 16 1
11 19 1
8 12 1
14 14 1
16 18 2
2 12 2
15 16 2
17 19 2
13 17 2
