width 20
height 20
.@...@@@@@@.@.@@@@@.
..@@.@@@@@....@.@.@.
.@.@.@@@@.@.@...@...
.....@.@....@.@...@.
@@.@...@@.@.@.@.@@@.
...@.@.@.@@@..@@..@.
@@.@@.....@.@.@.@.@.
@@@@@@.@@.....@....@
@@@@@@@...@.@...@@@@
@@@@@@@@@.@@..@...@@
@@@@@@@@@@@@@@@@.@@@
@@@@@@@@@@@@........
@@@@@@@@@@@@@@.@.@@@
@@@@@@@@@@@.@@..@@@@
@@@@@@.@@.@.@@.@@@.@
@@@@@...............
@@@@@@@@.@.@.@.@.@.@
@@@@@@@...@...@@@@@@
@@@@@@@@.@@@.@@@@@@@
@@@@@@@@@@@@@@@@@@@@
16
15 3 0
12 1 0
17 6 0
14 14 0
9 9 0
15 11 0
13 1 1
15 6 1
19 2 1
19 1 1
10 15 1
18 15 2
5 4 2
12 15 2
8 5 2
11 2 2

5 4 0
17 2 0
17 6 0
15 8 0
9 8 0
13 7 0
13 5 1
19 2 1
11 1 1
13 9 1
3 0 1
6 6 2
0 3 2
13 11 2
13 2 2
6 3 2
