width 20
height 20
@@@@@@@@.@..@....@@@
@@@@@@....@.@.@@@@@@
@@@@@..@@@..@..@@@@@
@@@@@@.....@..@.@...
@@@@@@@.@@.@@.....@.
@@@@@@@@......@.@..@
@@@@@@@.@@@.@..@.@..
@@@@@@@.....@@@....@
@@@@@@..@@.@...@.@..
@@@@@@@..@..@@.@.@.@
@@@@@@..@@.@.@....@@
@@@@@@@@@@@...@.@@@@
@@@@@@@@@@..@....@@@
@@@@@@@@@.@.@@@.@.@.
@@@@@@@.@...@@@...@.
@@@@@@@...@.@@..@...
@@@@@@@@.@...@@@.@.@
@@@@@@@@@..@@.@@....
@@@@@@@@@@.@@....@.@
@@@@@@@@@@@...@@.@..
9
18 16 0
17 5 0
19 6 0
9 17 0
9 5 0
9 15 0
15 0 0
13 18 0
16 16 0

19 8 0
10 16 0
15 4 0
17 4 0
13 5 0
14 10 0
14 12 0
15 18 0
18 15 0
