width 20
height 20
..@@@@@@@.@.@@@@@@@@
@..@@@.@..@..@@@@@.@
@@......@...@@@.@@.@
@@@.@@@@@@@..@..@...
@@.....@@@@.@.@.@@.@
@@.@.@...@..........
@...@..@...@@@.@.@@@
..@@.@..@.@@...@@..@
@.@@...@..@@.@..@@..
@@@..@.@@..@@..@@..@
@@@@..@.@@...@.@.@.@
...@.@@....@@......@
@@.....@.@.@@@.@.@@.
@@@.@.@@@..@@...@...
.....@@@@@..@@.@.@.@
@.@.@@@@@..@@.......
@@@@@@@@@@.@@@.@.@@@
@@@@@@@@@@@@@@@@....
@@@@@@@@@@@@@@@@@@.@
@@@@@@@@@@@@@@@@@@@@
9
10 14 0
10 12 0
3 9 0
2 6 0
1 11 0
4 2 0
8 5 0
16 12 0
17 7 0

1 7 0
8 5 0
16 11 0
5 8 0
0 7 0
10 11 0
19 3 0
4 12 0
14 15 0
