width 20
height 20
@@@@@@@@@@@@@@@@@@@@
@@@@@@@@@@@@@@.@@@@@
@@@@@@@@@@@@@...@@@@
@@@@@@@@@@@@.@.@.@@@
@@@@@@@@@@@@.@.@..@@
@@@@@@@@.@@..@.@@.@@
@@@@@@.@.@.@.@.@@.@@
@@@@@...........@.@@
@@@@@.@@.@.@.@@...@.
@@@@@@@@@..@@..@.@..
@@@@@.@@@@.@..@@.@@.
@.@@@.@@@@...@@.@@..
...@...@@..@....@.@.
@@..@.@@.@@@@.@.....
@@.@......@@.@..@.@.
@....@.@@..@..@.@@..
@@@@.@.@..@.@....@@.
@@@@@@@@@.....@@@@@@
@@@@@@@@..@.@@....@@
@@@@@@@@@@@....@.@@@
9
12 17 0
17 8 0
16 10 0
13 16 0
12 6 0
11 17 0
2 12 0
17 12 0
6 16 0

16 3 0
14 9 0
19 11 0
2 12 0
13 10 0
12 15 0
17 12 0
7 7 0
12 3 0
