width 20
height 20
@@@@@@@@@@@.@@@..@@@
@@@@@@@@@@@..@@.@.@@
@@@@@@@@@@..@.....@@
@@@@@@@@@@@.@.@.@.@@
@@.@@@@@@@@.@..@@.@.
.....@@@@@@.@.@@@...
@.@@..@@@@..@@.@@.@.
@@@..@.@@.@.@@....@.
@@@@.@.@.......@.@..
@@.......@@.@.@.@.@.
@..@@.@@...@@.....@@
..@@@...@.@.@.@.@@.@
@.@@@.@@.....@.....@
..@@@@...@.@..@.@.@.
@@@@@@.@..@..@@@....
@@@@@@..@@@.@.@@@@.@
@@@@@@.@@@..@..@@...
@@@@@@....@...@.@@.@
@@@@@@@.@.@@@.....@@
@@@@@@@@....@.@.@..@
9
18 8 0
15 1 0
9 14 0
1 13 0
19 8 0
11 14 0
5 10 0
15 10 0
2 4 0

12 17 0
14 18 0
7 13 0
8 8 0
19 5 0
10 8 0
17 6 0
17 2 0
15 1 0
