width 20
height 20
........@@@@........
.....@..........@...
...........@........
.......@............
....@..........@....
....................
........@.....@.....
.....@.@.......@@...
..................@.
............@.......
....@..............@
...@......@........@
..................@@
..............@....@
...@.@...@....@.@...
.......@..@..@@.....
....................
....................
...............@@...
...........@...@....
10
19 3 0
6 4 0
11 18 0
13 14 0
6 12 0
17 3 0
16 2 0
10 3 0
11 15 0
6 8 0

17 7 0
18 19 0
1 8 0
13 12 0
19 0 0
5 18 0
16 3 0
17 14 0
6 18 0
19 4 0
