width 20
height 20
.@@@@...........@.@@
.@@@@...............
.....@.........@....
..@.........@.......
...@.......@......@.
...................@
............@......@
................@..@
....@...............
.........@....@.....
............@..@....
....@...........@...
..........@.........
.......@...@......@.
..@.@.........@.....
.........@.....@....
....@@..............
..............@..@..
........@...........
@...........@@......
10
10 13 0
16 8 0
12 5 0
3 8 0
11 1 0
0 4 0
2 17 0
5 18 0
7 14 0
8 12 0

4 2 0
5 4 0
12 5 0
5 15 0
7 9 0
1 15 0
14 8 0
15 5 0
11 12 0
6 11 0
