width 20
height 20
............@..@@@@@
....@..@....@..@...@
..........@........@
...............@.@.@
............@.@.....
.@...@..............
...........@....@...
.........@....@....@
......@.........@...
.................@..
@..........@........
....@.@...@.........
.............@..@...
..............@.....
..........@..@....@.
.@.....@............
....................
.........@....@.....
....................
....................
10
11 19 0
6 2 0
2 12 0
12 12 0
1 11 0
9 18 0
10 12 0
4 9 0
15 11 0
15 10 0

11 19 0
4 5 0
11 0 0
5 12 0
6 7 0
4 7 0
0 0 0
12 2 0
12 13 0
9 14 0
