width 20
height 20
@@@@@........@......
@.@@@...@...........
..@..........@..@...
...............@....
.....@......@.......
@......@..@...@..@..
....................
.......@..@.........
........@......@....
....................
....@........@......
...........@.......@
.........@...@...@.@
@.@................@
......@.............
............@@@.....
............@@@..@..
...@................
....................
....................
10
0 19 0
5 18 0
14 13 0
15 2 0
17 1 0
1 4 0
3 9 0
5 17 0
1 5 0
4 12 0

13 3 0
17 10 0
5 11 0
11 1 0
3 19 0
18 18 0
8 19 0
16 0 0
0 4 0
11 3 0
