width 20
height 20
....................
..............@.....
...@..@.............
............@.......
.@..............@...
.......@............
....................
..........@..@......
........@...........
....................
....................
..@......@..........
......@.......@.....
@@..@........@......
@@.@............@...
@@....@.............
@@.........@..@.....
....................
...............@@@..
....@..........@@@@@
10
14 3 0
7 2 0
0 9 0
15 8 0
7 11 0
6 17 0
19 1 0
10 10 0
9 6 0
6 3 0

3 18 0
7 2 0
6 9 0
15 8 0
9 9 0
5 1 0
6 13 0
9 16 0
10 6 0
17 15 0
