width 20
height 20
@@..................
@@@....@.....@......
....................
.............@.@...@
....................
....................
..........@.........
....................
.....@...@..@.......
....@..........@.@..
.......@............
......@...@....@....
...@.........@....@.
....................
......@.........@...
.@.@.........@......
...@................
.........@..........
....................
..............@@@...
7
8 13 0
11 17 0
16 3 0
14 11 1
14 18 1
19 6 2
15 10 2

18 9 0
13 16 0
1 10 0
5 11 1
1 6 1
8 11 2
7 11 2
