width 20
height 20
..@@......@@.......@
...................@
...................@
.@..................
@.......@.@.........
...............@....
...........@.....@..
.@..@..@....@.......
...@.....@..........
....................
.@.......@....@.....
...@....@...@.....@.
....................
....@...............
.......@....@.......
.........@..........
.....@............@.
....@......@...@....
....................
............@@......
7
5 10 0
0 5 0
13 2 0
5 4 1
16 0 1
7 10 2
5 15 2

17 3 0
9 13 0
0 11 0
17 15 1
18 18 1
2 18 2
5 15 2
