width 20
height 20
..@.................
.............@......
.......@..@.@.......
....@...............
........@.@.........
..............@.....
@..............@....
....................
.......@.....@...@..
..@...@.............
...........@........
....@....@...@......
...................@
................@...
..@..@.....@......@.
@.......@...........
.......@............
........@...........
....@...............
................@...
7
6 16 0
17 9 0
1 17 0
10 0 1
4 4 1
11 11 2
15 5 2

18 0 0
13 10 0
15 2 0
1 2 1
13 3 1
19 11 2
2 17 2
