width 20
height 20
...@.@..@......@@@@@
@@.@...@.@@.@.@@@@@@
@....@@@.....@@@@@@@
@@@.@@@.@.@.@@@@..@.
...........@..@@@...
.@@.@.@.@.@@@..@..@.
...@@@.@.@@@..@.@..@
@.@.@@.@.@@.@.@...@.
................@...
@.@.@.@.@.@@.@.@@@@.
@@@@...@.@@.@...@@..
@@@..@@@....@@@.@@@.
@@@@.@.@@.@..@..@@.@
@@@@@....@..@@@.....
@@@.@.@.@.@...@.@@.@
@@...@......@@.@....
@.@.@.@.@.@......@.@
....@....@.@.@@.@..@
@.@...@.@...@....@..
...@.@....@@@@.@.@.@
3
7 3 0
9 3 0
15 14 0

3 15 0
11 15 0
4 4 0
