width 20
height 20
@@@@@@...........@@@
@@@@@..@@@@@.@@.@.@@
@@@@.@.@.@.@.@@@...@
@@@@........@.@.@.@.
@.@.@.@.@@@.........
.......@@@..@@.@.@@.
@.@.@.@@@@.@...@.@@.
@@..@@.@@@.@.@@.@.@.
.@@.@@..@@@.@.@.....
.....@.@@.@.....@.@.
@.@.@.......@.@.@@..
@@...@.@@.@.@.@@.@.@
@@.@.@.@@@...@...@@@
@.@.@@@.@.@.@.@@...@
.................@@@
@.@.@@@.@.@.@@.@.@.@
.@@@@@.@@..@@@@@....
..@.@.....@.@@...@.@
@.....@.@.....@.@...
..@.@..@@@.@.@..@@.@
3
3 4 0
13 3 0
3 7 0

17 16 0
15 17 0
11 11 0
