width 20
height 20
.@.@@@@@..@@@@@@@@@@
....@@@@.@@@@@@@@@@@
.@.@@@@...@@@@@@.@@.
.@..@@@@.@@@@@@@.@..
.@.@@@@....@@@@...@.
.@..@@..@.@@@@@@@.@.
.@@..@@.@..@..@@@...
..@.@...@.@@@..@.@.@
@.@@@@@.@.@@@@......
....@@.@@..@@@@@.@.@
@.@@@.....@.....@...
..@...@.@..@.@@@..@.
@...@@@@..@.....@@@.
@@.@@@@@@...@.@@@@@.
@@@@@@@@@@.@.....@@.
@@@@@@@@@@..@.@@....
@@@@@@@@@@@@...@.@@@
@@@@@@@@@@@@@.@.@@@@
@@@@@@@@@@@.....@@@@
@@@@@@@@@@@@@.@@@@@@
14
18 15 0
9 4 0
18 7 0
0 7 0
2 9 0
8 4 1
18 6 1
2 13 1
6 7 1
13 15 1
13 16 2
6 9 2
16 11 2
1 9 2

9 11 0
0 9 0
18 15 0
2 2 0
0 1 0
17 4 1
0 3 1
8 12 1
10 15 1
2 1 1
13 7 2
15 18 2
13 17 2
6 9 2
