width 20
height 20
...@@...............
...@........@.......
................@...
......@.@.@.........
.@..................
.........@..........
...@..@...........@.
............@.@.....
....................
.....@...@..@..@....
.@....@.............
....................
....@.....@.........
...............@....
@.............@.....
@.@.................
.....@..............
........@@..........
.@.@....@@..........
@..@................
6
5 7 0
10 4 0
7 3 1
12 4 1
14 0 2
1 9 2

11 19 0
19 18 0
18 11 1
18 1 1
18 8 2
1 9 2
