width 20
height 20
.........@@@@.......
...@...@............
......@............@
...@.........@.@....
.....@...@..........
....................
....................
@.@.....@.@....@....
@....@..............
..............@.....
....................
.........@...@...@..
..@..@.........@....
..........@.........
..@.........@..@....
......@.......@.....
.....@.....@........
.............@......
..@.................
....................
6
11 17 0
16 4 0
4 1 1
16 0 1
12 12 2
5 10 2

11 5 0
5 6 0
9 7 1
2 17 1
16 0 2
8 17 2
