width 20
height 20
@.............@.....
....@.@.............
.........@..........
..@..........@....@.
....@...............
...@........@.......
......@.........@...
.....@.......@..@...
....@...............
......@...@......@..
.........@..........
............@.......
....................
.@.......@..@..@....
..........@.........
...@................
......@..........@..
....@......@...@....
.@..................
.......@............
6
6 19 0
15 1 0
0 5 1
18 16 1
12 6 2
12 3 2

19 2 0
2 17 0
19 12 1
10 3 1
16 10 2
16 17 2
