width 20
height 20
....................
...............@....
..@...@.............
.....@..............
@@....@.........@.@@
.....@.........@@...
.@@.................
.@@.................
.....@..@...........
....................
.....@..............
.........@..........
..@.........@.......
.........@.....@....
....@..@............
.....@.......@...@..
@...........@.......
@...@........@......
@@..................
@@..................
5
9 16 0
12 10 0
2 16 1
14 14 1
13 7 2

14 1 0
1 0 0
11 4 1
5 13 1
0 0 2
