width 20
height 20
......@@@...........
....................
......@@............
.......@............
@..........@........
..................@@
.....@......@.....@.
..@......@.@.@......
...................@
......@.@..@........
...@....@...........
...........@........
.....@.........@....
......@...@...@...@.
....................
@@...@..@........@..
@@.....@............
@.@.............@...
...........@...@@@@@
...............@@@@@
5
12 15 0
14 18 0
7 10 1
0 8 1
6 18 2

0 0 0
0 6 0
19 0 1
0 10 1
7 5 2
