width 20
height 20
................@..@
.@..@.....@.........
@@............@.....
.......@.......@....
...@......@.........
...............@....
..................@.
...@.....@..@...@...
........@...........
.@..........@...@...
...@.@.....@.....@..
..@.......@..@......
....................
........@.....@.@..@
...................@
...........@........
.....@.........@....
..@.....@@..........
.....@......@.......
..................@.
5
9 3 0
18 12 0
19 5 1
9 13 1
6 10 2

11 19 0
4 4 0
19 2 1
12 4 1
17 3 2
