width 20
height 20
.@...........@......
......@.............
............@.......
...........@........
..@.................
........@...........
...@......@.....@...
....................
.....@........@.....
..@.................
....@.@..........@..
............@.......
....................
...@.......@.......@
.@...@...........@..
...............@....
.....@...@.......@..
....................
..@...@.............
................@@@@
5
5 7 0
9 11 0
4 8 1
1 15 1
5 18 2

6 7 0
19 16 0
17 13 1
19 5 1
19 0 2
