width 20
height 20
....................
...........@........
.........@..........
.............@.@....
.....@.....@........
.@....@.............
....................
....@....@.........@
.@......@....@..@...
.....@...@..........
....................
.....@..........@...
.......@............
...........@..@.....
....................
@....@.@..@.........
@...................
@...................
@@.......@.....@....
@@...........@......
9
13 14 0
13 18 0
4 5 0
19 12 0
9 1 0
1 2 0
17 7 0
19 14 0
4 12 0

0 1 0
12 13 0
18 18 0
19 13 0
14 10 0
5 6 0
12 4 0
0 0 0
13 1 0
