width 20
height 20
.@@@.@..@..@@@..@@@@
..@...@.@.@.@.@..@@@
.@.@@...........@.@@
......@.@.@@.@@.....
@.@.@..@..@@@@@@@.@.
.@@..@@@@..@.@..@@..
.@.@...@.@.....@@@@.
...@.@....@.@@..@@@.
.@@@@@.@@..@@@.@@@@@
...@..@@..@.@.@@@@@@
.@..@....@@....@@@@@
@.@.@.@.@@@@@.@.@.@@
......@@.@@........@
.@.@@.@..@.@.@@.@.@.
..@@@..@....@@...@..
.@@@@@...@.@...@@.@.
@.@.@.@.@..@.@......
@...@...@@..@..@@@@.
@.@...@.@..@.@.@.@@.
@@@@.@..@@.....@....
1
7 10 0

11 6 0
