width 20
height 20
.@.@.@.@@.@...@.@@@@
...@......@.@@.....@
.@@..@@.@......@@@..
...@...@@@.@.@.@@..@
.@.@.@..@@@.@.@@.@.@
..@@@..@.@@...@....@
@..@.@......@@.@.@..
@.@....@.@.@.....@.@
..@@.@..@...@.@@@...
@..@..@..@.@.....@.@
.@.@.@@.@@.@@.@.@.@@
.......@..@....@...@
.@.@@@@..@@@.@...@@@
..@.@.@.@..@.@.@@@@@
.@........@.@...@@@@
..@.@@.@@....@.@.@.@
@@..@...@@.@...@....
@..@.@@...@..@@..@.@
@.@..@..@@.@...@.@..
....@@@@@....@....@@
1
4 6 0

14 14 0
