width 20
height 20
@@..................
@@@..@..............
@@@.........@.@.@...
@@@......@..........
.....@.......@...@..
.@.........@........
.......@.......@....
......@............@
........@..@.......@
....@.........@.....
....................
.........@......@...
...@......@.........
............@@......
..@...@.............
..........@....@....
...@................
...........@...@....
............@.......
....................
8
11 4 0
5 15 0
4 17 0
18 9 0
17 0 0
13 7 0
3 5 0
1 12 0

0 17 0
4 16 0
14 0 0
18 0 0
2 18 0
16 5 0
12 11 0
13 3 0
