width 20
height 20
....................
....................
.................@..
.................@..
.....@..@....@......
....@..@...........@
.............@....@@
..@........@......@@
.......@.@.........@
....@..@............
....@@....@....@....
..@...........@..@..
.......@..........@.
.....@.....@........
..........@.........
....@......@........
..@...........@.....
.....@.....@........
.............@......
...@@..@@...........
8
10 12 0
18 16 0
0 1 0
2 4 0
11 12 0
1 4 0
9 10 0
14 10 0

3 0 0
0 4 0
3 4 0
3 13 0
11 12 0
19 13 0
19 0 0
2 3 0
