width 20
height 20
@...................
......@......@......
..@..@..............
.........@..........
......@...@.......@.
....................
.......@......@...@.
...@................
.................@..
......@....@....@...
..@..............@..
...@.......@........
.@...........@......
............@..@...@
...........@......@@
.@.@.....@..........
.........@.@@.....@@
........@@@@@@@@@@@@
.........@@@@@@@@@@@
....@@....@@@@@@@@@@
8
10 3 0
14 1 0
16 1 0
5 18 0
12 7 0
4 14 0
15 11 0
6 0 0

3 18 0
9 19 0
8 14 0
3 13 0
3 17 0
19 0 0
14 8 0
15 10 0
