width 20
height 20
..................@@
......@...........@@
............@.....@@
...@.........@....@@
....@.........@...@@
.@................@@
......@.@....@......
....................
............@...@...
...@................
..@........@....@...
.....@..@...........
................@...
...@................
..@.................
...........@........
@...@...@@.......@..
...@................
.....@..............
.................@..
8
1 19 0
12 5 0
12 10 0
4 0 0
13 5 0
8 3 0
12 6 0
9 0 0

11 6 0
12 19 0
9 2 0
19 16 0
12 18 0
19 19 0
12 4 0
11 0 0
