width 20
height 20
@@.@.@.@.@...@.@@@@@
@..........@....@..@
@@@.@.@.@.@..@@.@@..
..@..@@@@.@@@@.....@
@...@@.@.@@@..@.@.@.
..@@@@....@..@@@....
.@.@.@.@@..@..@.@.@.
...@....@.@@.@@...@.
.@.@.@@@@@@...@.@@..
@.......@@@.@..@@@@.
@.@.@.@@@@...@@.@@..
@@.@@.@@@@@.@....@@.
......@@@@....@.@.@.
@.@.@.@@.@@.@@......
...@.@.....@@@@.@.@.
@@....@@.@@@@....@@@
@@@@@.@...@@@@.@..@@
@@@@@...@.@@@@@@.@@@
@@@@..@@..@@@@@@@@@@
@@@@@.@@@...@@@@@@@@
14
16 16 0
16 3 0
16 15 0
3 9 0
14 13 0
4 12 0
17 5 0
12 12 0
14 1 0
2 7 0
10 14 0
9 2 0
8 13 0
3 13 0

0 8 0
10 14 0
16 15 0
11 10 0
3 9 0
13 1 0
17 5 0
1 9 0
19 6 0
19 8 0
17 13 0
15 12 0
6 17 0
18 1 0
