width 20
height 20
@@@@@.@@@@@@@@@@@..@
@@@@...@@@@.@@@@@@.@
@@...@@@@.....@.....
@@.@..@@@.@@@@@.@.@.
@@@..@.@@.@.@...@@@.
@@@@........@.@@@.@@
@@@@@.@.@.@.@.@...@@
@@@@@@...@..@...@.@@
@@@@@@@.@.@.@.@@.@..
@@@@@@@....@.......@
@@@@@@@@@.@@@@@.@@..
@@@@@@@....@@@@@.@.@
@@@@@@.@.@@@@@......
@@@@@@...@@@@.@@.@@.
@@@@@@.@.@.@.....@..
@@@@@@..@@..@.@@@@@.
@@@@@@.@@.@....@@..@
@@@@@.......@@....@.
@@@@@@.@@.@...@.@...
@@@@@@@@@@..@..@..@.
14
19 14 0
14 16 0
5 1 0
13 18 0
17 12 0
13 19 0
17 19 0
19 18 0
11 19 0
15 2 0
9 8 0
18 2 0
13 7 0
13 14 0

18 10 0
4 4 0
6 4 0
12 18 0
5 6 0
10 2 0
16 2 0
11 4 0
11 17 0
11 15 0
13 7 0
7 9 0
16 9 0
18 18 0
