width 20
height 20
@@@@@@@@.....@@..@@@
@@@@@@@@@@.@.@@.@.@@
@@@@@@@@@@@........@
@@@@@@@@....@.@.@.@.
@@@@@@@@.@@..@@@@...
@@@@@@@@@@@@@@@@.@@.
@@@@.........@@@....
@@@@@.@@@.@@..@@@@.@
@@.....@@@...@.@.@..
@..@.@@@@@@@...@...@
@@.@@@@@@@...@...@..
@...@@@@@@@.@.@@@..@
.@@...@@@@@@@.@...@@
....@..@@@@@....@..@
@.@..@@@@@@@.@.@@.@@
@..@.@@@@@@@@..@@@@@
..@@@@@@@@@@@@.@@@@@
@...@@@@@@@@@@@@@@@@
@@.@@@@@@@@@@@@@@@@@
@@.@@@@@@@@@@@@@@@@@
14
13 2 0
14 14 0
13 11 0
12 4 0
10 6 0
11 11 0
12 6 0
13 3 0
2 13 0
17 6 0
8 6 0
12 9 0
17 14 0
16 8 0

5 8 0
15 13 0
5 13 0
15 0 0
9 7 0
0 12 0
11 11 0
5 12 0
18 6 0
1 15 0
2 11 0
18 2 0
2 8 0
11 2 0
