width 20
height 20
@@@@@@@@.@.@@@@@@@@@
@@@@@......@@@@@@@@@
@@@@@@.@@@..@@@@@@@@
@@@@@@.@.@@..@@@@@@@
@@@@@@@.....@@.@@@@@
@@@@@@@@.@@.....@@@@
@@@@@@@@...@@.@@.@@@
@.@@.@...@.@@@@@...@
..@...@@..@@@@@@.@.@
@.@@.@.@.@@@@@@..@@@
..........@@@@@.@@@@
@.@.@@@@.@@@@@@..@@@
@..@@@....@@@@@.@@@@
..@@@@@@.@.@@@@.@@@.
.@@@@@@..@.@.@...@..
.@.@.@@@......@.@.@.
........@.@.@.......
.@@.@.@..@@@@@@@@.@.
@@.@@@@.@.@.@@@@@@..
.............@@@@@@@
14
14 4 0
11 2 0
8 19 0
4 15 0
16 6 0
11 15 0
8 7 0
2 18 0
16 16 0
13 15 0
17 7 0
15 14 0
15 10 0
0 13 0

17 7 0
0 19 0
19 14 0
6 1 0
7 7 0
14 5 0
15 15 0
6 2 0
7 14 0
10 6 0
10 15 0
15 16 0
14 4 0
6 7 0
