width 20
height 20
..................@@
..............@....@
@.@........@....@...
@....@..............
@.........@....@....
@....@..........@...
@@..................
@@........@.........
.........@.....@.@..
.......@............
..........@..@......
@....@.@........@..@
......@..@.@........
.@..................
............@.......
......@..@.....@....
....................
.@........@.@.@.....
...........@.....@@.
@...............@@@@
12
10 6 0
17 14 0
13 12 0
12 2 0
19 3 1
19 14 1
18 11 1
4 1 1
19 4 2
7 14 2
19 13 2
15 17 2

9 0 0
0 0 0
18 2 0
3 17 0
10 2 1
1 2 1
1 0 1
19 18 1
17 17 2
2 10 2
17 1 2
2 6 2
