width 20
height 20
....................
.........@..........
....................
...@..@.............
.@........@......@..
...@..@..@....@.....
.............@.@.@..
..@@.....@..........
..........@.@.......
......@............@
........@..@....@..@
...................@
.........@.........@
@...@...@...@......@
@..@...............@
.............@......
.......@............
.....@....@.........
................@...
....................
12
12 3 0
1 10 0
7 17 0
18 5 0
8 4 1
9 19 1
6 4 1
6 7 1
4 18 2
8 2 2
7 14 2
12 6 2

14 15 0
17 17 0
1 5 0
18 4 0
6 0 1
8 1 1
7 4 1
14 18 1
18 0 2
8 2 2
17 0 2
9 15 2
