width 20
height 20
@..@@...............
....@.........@.....
...........@.@......
.......@............
.............@.@....
.@.@.@.....@........
...............@....
....................
............@....@@@
....................
..@.................
..........@.....@...
..@.@.@.@........@..
...@..............@.
.....@.@............
..........@.........
...@..@..@..........
..............@....@
.@............@@..@@
...........@..@@@@@@
12
2 15 0
12 9 0
1 15 0
6 3 0
4 8 1
1 13 1
5 6 1
17 2 1
18 6 2
5 0 2
15 2 2
8 2 2

8 3 0
2 16 0
12 13 0
13 18 0
3 8 1
18 17 1
12 1 1
16 4 1
11 0 2
0 17 2
15 0 2
8 8 2
