width 20
height 20
.................@..
...@.............@..
....................
...@................
..........@.........
.....@............@.
...........@.@......
.........@..........
.........@..........
.........@@..@......
.........@@@....@..@
@@@.................
............@.......
................@.@.
....@....@..........
.....@........@.....
..........@.........
.....@...@.@....@...
@............@......
@@..................
12
0 2 0
4 4 0
0 7 0
14 16 0
19 17 1
1 1 1
6 5 1
16 19 1
5 14 2
19 4 2
0 17 2
2 8 2

11 15 0
12 11 0
14 12 0
2 18 0
5 19 1
1 3 1
19 17 1
6 3 1
14 0 2
5 11 2
5 14 2
17 19 2
