width 20
height 20
..................@@
.@................@@
..@...@......@......
...@...........@....
..@@...........@....
..@@....@.@.........
................@...
@.....@....@........
@.........@..@......
.........@....@.....
......@.............
..@..........@.@....
....................
.........@..@.@.....
......@...........@.
...@@.....@..@......
...@@...............
....@...............
.........@..........
....................
3
10 18 0
6 8 0
17 16 0

8 19 0
17 19 0
19 13 0
