width 20
height 20
....................
.........@.......@..
@...................
.........@.........@
............@...@...
.........@...@......
..............@.....
..@.......@....@....
...........@....@..@
..@......@..@.......
.........@..........
......@.....@.@.....
.....@..............
.................@..
....................
.....@....@.........
.@.....@............
...@...........@....
....................
@.................@@
3
1 4 0
5 7 0
10 6 0

3 6 0
12 7 0
0 18 0
