width 20
height 20
..........@@@@..@..@
.........@..........
....................
.....@........@.....
...@.....@..........
..........@......@..
@....@..............
...@..........@.....
........@...........
.................@..
@.........@.........
@.....@.....@.......
@.............@.....
@.......@.........@@
.............@....@@
.....@............@@
.@.......@......@.@@
....................
..@.@......@........
..@.................
16
9 11 0
17 10 0
19 6 0
5 4 0
1 14 0
3 10 0
9 12 0
13 16 0
9 15 0
16 11 0
15 18 0
4 3 0
1 8 0
0 7 0
2 11 0
0 5 0

9 11 0
5 16 0
5 18 0
11 15 0
17 0 0
12 17 0
6 10 0
2 5 0
18 0 0
14 9 0
0 3 0
1 0 0
13 11 0
17 18 0
2 11 0
15 4 0
