width 20
height 20
................@@@@
..@...............@@
.............@......
......@.@.....@...@@
....................
............@..@....
........@..........@
....@.@.......@.....
............@.......
......@.@.@.........
............@..@..@.
.....@@.........@...
@....@..............
@..@........@.@.....
@.......@..@.......@
.......@.......@....
....................
....@@@@............
.......@......@....@
.......@@@@.......@@
16
11 2 0
15 19 0
0 19 0
1 0 0
19 8 0
8 0 0
7 14 0
16 14 0
19 7 0
4 6 0
12 3 0
19 9 0
9 5 0
8 7 0
3 17 0
18 12 0

0 15 0
11 8 0
3 18 0
9 3 0
17 8 0
18 16 0
7 7 0
14 4 0
9 12 0
16 19 0
1 17 0
19 8 0
8 13 0
0 1 0
8 16 0
13 3 0
