width 20
height 20
.......@............
.......@............
....@......@..@.....
..........@......@..
....................
...@..........@.....
.................@..
......@.............
...........@........
.............@......
...@.....@..........
..@....@......@.....
.....@...@....@.....
..............@.....
...@.@...@..........
..........@...@.....
......@.@...........
...@.....@..........
...@................
...@@@@...@........@
16
18 3 0
1 11 0
12 4 0
11 14 0
16 7 0
16 16 0
6 13 0
10 13 0
14 19 0
2 15 0
17 16 0
8 9 0
14 18 0
1 0 0
18 1 0
2 9 0

17 19 0
10 8 0
0 16 0
0 0 0
2 18 0
0 11 0
12 15 0
6 15 0
2 2 0
3 8 0
1 6 0
2 19 0
14 18 0
18 13 0
10 13 0
19 1 0
