width 20
height 20
.....@..........@...
...@................
............@.......
....................
...@........@...@...
.........@..........
.....@.........@....
....@...............
......@..@..........
.......@............
....................
........@....@...@.@
..@.................
.....@..@...........
....@.......@.......
...@..@....@...@....
.@...........@@.....
..........@.....@...
.......@............
....................
16
19 17 0
11 16 0
5 10 0
12 18 0
17 6 0
3 18 0
19 16 0
19 14 0
3 12 0
18 11 0
0 9 0
4 17 0
11 7 0
2 10 0
10 14 0
2 2 0

16 14 0
1 10 0
19 17 0
3 0 0
19 13 0
7 16 0
0 5 0
9 12 0
7 14 0
0 14 0
16 18 0
19 9 0
0 18 0
8 3 0
0 6 0
17 15 0
