width 20
height 20
@@@@...@@@@@@@@@@.@@
@@@@.@@@@@@@@@@@@.@.
@@.@.@@@@@@@.@@@..@.
@.....@.@@@@..@@@.@.
..@.@........@@...@.
.@...@.@.@.@...@@...
.@@.@@..@@@.@.@.@@.@
@@@@@@@@@@.........@
@@@@@@@@@@@.@.@@@@.@
@@@@@@@@@@@@.....@.@
@@@@@@@@@@@@@.@@.@..
@@@@@@@@@@@..@@@..@.
@@@@@@@@@@@@..@@@..@
@@@@@@@@@@@@.@.@..@@
@@@@@@@.@.@....@.@.@
@@@........@.@......
@@@@@.@.@@.@..@.@@@.
@@@@...@@@..@..@....
@@@@@@.@@@@.@.@@@.@.
@@@@@@@@@@....@@@@@.
13
6 18 0
18 12 0
5 3 0
8 5 0
2 3 0
11 19 0
17 2 0
5 4 0
9 15 0
18 14 0
12 14 0
14 15 0
4 15 0

17 18 0
7 14 0
18 8 0
15 6 0
14 14 0
18 12 0
18 10 0
14 5 0
16 15 0
3 15 0
11 11 0
4 3 0
12 14 0
