width 20
height 20
@@@@@@@@@@@@..@@.@..
@@@@@@@@@@@..@.@.@.@
@@@@@@@@@.@@.@......
@@@@@@@@@......@@@@@
@@@@@@@@@@.@.@@.@@..
@@@@@@@@@@@@.......@
@@@@@@@@@@.@.@.@.@..
@@@@@@@@@@....@.@.@.
@@@@@@@@@@@.@@@.@.@.
..@@@@@.@@....@.....
@..........@.@@@@.@.
.@.@.@.@@.@...@@...@
.@..@@@..@@@.@@@@@..
...@.@@.@@@@..@....@
.@.......@@@.@.@@@@.
.@.@.@@@@@@.........
..@@@@@@@@.@@.@.@@.@
.@@@@@@@@...@@.@....
..@.@@@@@@@.@@.@.@.@
@.....@@@@........@@
13
13 19 0
12 12 0
14 1 0
5 10 0
18 13 0
19 4 0
16 19 0
0 14 0
13 13 0
18 18 0
13 0 0
3 19 0
10 17 0

12 14 0
17 13 0
11 15 0
14 15 0
18 6 0
15 16 0
12 7 0
11 17 0
11 8 0
8 10 0
15 19 0
4 15 0
7 10 0
