width 20
height 20
@@@@..@@@..@@@@@@@@@
@@@@.@.@@@..@@@@@@@@
@@@........@.@@@@@@@
@@..@.@.@@....@@@@@@
@@@@..@..@@@@.@@@@@@
@@@@@@@.@.@.@.@@@@@@
@@@....@....@..@@@@@
@..@.@@@@.@...@@@@@@
..@...@.@@..@@@@@@@@
.@..@@@....@.@@@@@@@
...@.@..@@...@@@@@@@
.@.....@@@@.@@@@@@@@
.@.@.@.@@@@@@@@@@@@@
..@@@...@@@@@@@@@@@@
.@@@.@.@.@@@@@@@@@@@
@@........@@@@@@@@@@
@..@@@@.@..@@@@@@@@@
@@.@@@@.@.@.@@@@@@@@
@@.@@@@@....@@@@@@@@
@@@@@@@@@.@..@@@@@@@
13
2 7 0
9 15 0
13 6 0
4 12 0
9 5 0
1 16 0
12 10 0
10 1 0
11 11 0
2 10 0
7 17 0
11 10 0
4 4 0

7 2 0
5 4 0
11 18 0
6 1 0
12 3 0
8 14 0
7 9 0
2 16 0
4 11 0
7 13 0
9 19 0
6 11 0
5 2 0
