width 20
height 20
.........@.........@
....................
.................@..
...........@........
.......@.......@....
.........@@.........
....@...@@@.........
........@.....@.....
...@......@......@..
..@....@............
...@.........@......
....@.......@.......
.....@..@......@.@..
..........@.........
....................
....................
.........@......@...
........@.@.........
...@..............@@
..@@@.......@@@..@@@
8
15 3 0
9 2 0
11 1 0
17 5 1
0 15 1
2 0 1
0 12 2
12 4 2

0 16 0
18 9 0
1 5 0
18 4 1
12 8 1
10 14 1
6 19 2
5 0 2
