width 20
height 20
....................
..................@.
...@.......@.@......
....................
@.....@@...........@
..........@.........
...@...@............
.............@..@.@.
.....@..@..........@
.@..@........@..@...
.@......@...........
......@..........@..
...@.......@........
....................
...@..@.............
@.@..........@......
......@....@........
..............@.....
..................@.
@@@@..............@.
8
2 10 0
14 10 0
19 5 0
15 17 1
0 10 1
12 7 1
10 15 2
19 16 2

0 14 0
2 6 0
0 16 0
14 19 1
3 0 1
2 17 1
18 3 2
9 0 2
