width 20
height 20
.......@@@...@@@....
@......@@@....@.....
..................@.
@@..............@...
@........@..........
............@.......
@...................
@.....@..@.........@
@..............@....
@........@....@.....
......@.....@.......
.....@...........@..
...........@........
..@.....@........@.@
......@............@
....@.........@.....
...........@........
...@................
...............@.@@@
....@............@@@
8
17 15 0
10 9 0
13 4 0
17 3 1
16 1 1
17 0 1
15 15 2
8 5 2

0 18 0
15 17 0
6 11 0
8 15 1
3 10 1
1 19 1
5 1 2
19 15 2
