width 20
height 20
....................
@....@............@.
.........@..........
.@.@................
..@..@..............
..@.....@........@..
............@.......
.....@..............
.....@.........@....
........@....@......
..@..@..............
...@................
........@......@..@.
...@.....@..........
.....@....@..@......
.@.....@............
........@.....@.@...
....@...............
...........@........
...@................
8
9 10 0
13 3 0
9 15 0
0 13 1
11 8 1
5 5 1
18 19 2
2 19 2

6 15 0
0 19 0
19 4 0
19 0 1
0 18 1
6 9 1
18 19 2
0 7 2
