width 20
height 20
....@...............
..............@...@@
.....@....@.@@......
......@.@......@....
....................
...........@........
.........@...@.@.@..
..................@.
......@.....@.......
..@......@...@..@...
....................
@@@.......@.........
@........@.@.....@..
@.@.....@.....@.....
..............@@....
.....@..............
..@....@........@...
............@.....@.
....................
........@@..........
8
10 9 0
18 16 0
7 15 0
12 10 1
18 9 1
17 0 1
14 8 2
1 1 2

9 15 0
13 19 0
19 2 0
0 19 1
16 5 1
12 5 1
0 15 2
19 19 2
