width 20
height 20
@@@@@@@@@@@.........
@@@@@@@@@@@.@.@.@@@.
@@@@@@@@@@...@...@@@
@@@@@@@.@@@.@..@.@@@
@@@@@@..@@...@@@@@@@
@@@@...@@.@.@..@@@@@
@@@@.@....@.@@.@@@@@
@@@@@@@.@.@.........
@@@@@...@.@.@@.@@.@.
@@@@@@.@....@@@....@
@@@@@@@@.@.@@@@@.@..
@@@@@@@@@@@@@@@@@.@.
@@@@@@@@@@.@@@@@....
@@@@@@@@@@...@@.@.@.
@@@@@@@@@@@.@......@
@@@@@@@@@.....@@.@@.
@@@@@@@@@@.@@...@@@.
@@@@@@@@@@...@.@....
@@@@@@@@@@.@.@...@.@
@@@@@@@@@@@..@@@.@..
12
10 16 0
12 18 0
12 0 0
10 15 0
7 8 0
5 8 0
9 5 0
12 2 0
7 7 0
8 10 0
14 16 0
18 18 0

7 6 0
16 9 0
16 12 0
18 14 0
16 10 0
17 14 0
14 2 0
10 15 0
7 7 0
17 8 0
14 14 0
9 15 0
