width 20
height 20
@@@@@@@@@@@@@@@@@@@@
@@@@@@@@@@@@@@@@@@@@
@@@@@@@@@@@@@@@@@@@@
@@@@@@@@@@@@@@@@@@@@
@..@@@@@@@@@@@@@@@@@
..@@@@@@@@@@@@@@@@@@
@.@@@@@@@@@@@@@@@@@@
...@@@@@@@@@@@@@@@@@
.@@@@@@@@@@@@@@@.@@@
...@@@@@@@@@@@@...@@
.@@@@@@@@@@@@@.@.@@@
..@@@@@@.@@@@@...@@@
@..@@@....@@@..@@.@@
@.@@.@@.@@.@.@.@..@@
@..............@@..@
@.@.@.@@@@.@.@....@.
@.@@@@@@@@@@@..@.@..
@@@@@@@@@@.@.@.@.@.@
@@@@@@@@@@....@.....
@@@@@@@@@@@.@...@.@.
12
4 13 0
17 9 0
1 16 0
8 14 0
12 15 0
2 9 0
1 7 0
6 12 0
17 19 0
5 15 0
12 14 0
0 8 0

13 16 0
11 18 0
12 14 0
14 16 0
1 7 0
16 17 0
16 10 0
5 14 0
2 9 0
13 19 0
14 19 0
7 12 0
