width 20
height 20
@@@@@@@@@@@@@@@@@@.@
@@@@@@@@@@@@@@@@@...
@@@@@@@@@@@@@@@@..@.
@@@@@@@@@@@@@@@@@..@
@@@@@@@@@@@@@@@@..@@
@@@@@@@@@@@@@@..@..@
@@@@@@@@@@@@@..@@.@@
@@@@@@@@@@@@@@..@.@@
@@@@@@@@@@@@@..@@..@
@@@@@@@@@@@@@@..@.@.
@@@@@@@@@@@@@@.@....
@@@@@@@@@@@@@@..@.@@
@@@@@@@@@@.@@..@@...
@@@@@@@@@@.@.@.@..@.
@@@@@@@@@@......@.@.
@@@@@@@@@@@.@.@....@
@@@@@@@@@@@@@@@@@@.@
@@@@@@@@@@@@@@@@@@..
@@@@@@@@@@@@@@@@@@.@
@@@@@@@@@@@@@@@@@@@@
12
12 13 0
17 8 0
17 7 0
18 10 0
17 6 0
18 1 0
15 5 0
18 0 0
16 10 0
14 7 0
18 15 0
13 14 0

12 13 0
18 1 0
18 16 0
19 10 0
17 7 0
18 5 0
13 8 0
19 12 0
19 9 0
12 14 0
17 8 0
11 15 0
