width 20
height 20
..@..@..@...@@@@@@@@
.@.@.@.@.@@...@@@@@@
.........@.@.@@..@@@
@@@@.@.@...@.@.@.@.@
@@...@.@@@.@........
@@@@..@.@....@@.@@.@
@@@@.@@..@.@.@.@...@
@.@.@..@.@@..@...@..
.....@...@@@..@.@.@.
.@.@..@@.@@..@@.@.@.
@@@@@.@....@.@....@.
@@@@@..@.@...@@.@@@@
@@@@..@.@@.@.@@@@@@@
@@@@@....@..@.@.@@@@
@@@@@@.@.@@.....@@@@
@@@@@@@.....@.@@@@@@
@@@@@@@@.@.@..@@@@@@
@@@@@@@.@.@.@...@@@@
@@@@@@..@.....@@@@@@
@@@@@@@...@.@...@@@@
12
10 0 0
8 13 0
10 10 0
13 17 0
10 5 0
6 13 0
11 15 0
17 9 0
6 0 0
13 15 0
4 9 0
1 7 0

7 5 0
5 9 0
12 16 0
8 14 0
6 18 0
17 8 0
10 15 0
15 2 0
12 5 0
15 14 0
14 17 0
1 0 0
