width 20
height 20
@@@@@@@..@..@@@@..@.
@@@@@@.@.@.@.@@.@.@.
@@@@@...............
@@@@@.@.@.@@@.@@.@.@
@@@@@@...@..@.@.@..@
@@@@@@.@@.@.@...@.@@
@@@@@..@....@.@..@.@
@@@@..@@@.@..@@@....
@@@@@@@@@.@.@@@.@@.@
@@@@@@@@@@......@@.@
@@@@@@@@@@@.@.@....@
@@@@@@@@@@.@.@.@@@..
@@@@@@@@@..........@
@@@@@@@@.@.@.@.@.@..
@@@@@@@.....@@@...@.
@@@@@@@@.@.@@@.@.@.@
@@@@@@@@@@@@@......@
@@@@@@@@@@@@@@.@.@.@
@@@@@@@@@@@@@@@.@...
@@@@@@@@@@@@@@....@.
4
11 4 0
19 18 0
17 10 1
18 17 2

17 7 0
9 8 0
14 16 1
16 14 2
