width 20
height 20
@@@@@@@@@@@...@@@@@.
@@@@@@@@@@..@.@@@.@.
@@@@@@@@@@@@........
@@@@@@@@@@@@@.@.@.@.
@@@@@@@@@@@@@@..@@..
@@@@@@@@@@@@@@@..@@.
@@@@@@@@@@@@@@@@@.@.
@@@@@@@@@@@@@@@@....
@@@@@@@@@@@@@@@@@.@@
@@@@@@@@@@@@@@@@....
@@@@@@@@@@@@@@@@.@@.
@@@@@@@@@@@@@...@...
@@@@@@@@@@@@..@@..@.
@@@@@@@@@@@@@.@.@.@@
@@@@@@@@@@@@........
@@@@@@@@@@@@@@@.@.@.
@@@@@@@@@@@@@@@@@@..
@@@@@@@@@@@@@@@@@@@.
@@@@@@@@@@@@@@@@@@..
@@@@@@@@@@@@@@@@@@@.
4
16 14 0
13 1 0
12 2 1
19 2 2

13 13 0
17 6 0
17 11 1
17 14 2
