width 20
height 20
...@@.@.....@.@.@@..
.@..@.@.@.@.....@.@.
@..@@..@@.@.@@@.....
.@.@@.@....@..@.@.@@
.......@@@..@..@@@@@
.@.@.@@@...@@.@@@@@@
@.@..@..@.@....@@@@@
....@.@.....@.@.@@@@
@.@.....@.@@@....@@@
@.@.@.@.@@..@.@@.@@@
@..@..@....@....@@@@
@.@..@@.@.@@@.@.@@@@
@@@@...@@@@@@@@@@@@@
@@@@.@@@@@@@@@@@@@@@
@@@@@@@@@@@@@@@@@@@@
@@@@@@@@@@@@@@@@@@@@
@@@@@@@@@@@@@@@@@@@@
@@@@@@@@@@@@@@@@@@@@
@@@@@@@@@@@@@@@@@@@@
@@@@@@@@@@@@@@@@@@@@
4
1 0 0
6 2 0
17 2 1
13 10 2

2 0 0
9 8 0
5 9 1
9 7 2
