width 20
height 20
@@@@@@@@@@@@@@@@@@@@
@@@@@@@@@@@@@@@@@@@@
@@@@@@@@@@@@@@@@@@@@
@@@@@@@@@@@@@@@@@@@@
@@@@@@@@@@@@@@@@@@@@
@@@@@@@@@@@@@@@@@@@@
@@@@@@@@@@@@@@@@@@..
@@@@@@@@@@@@@@@@@..@
@@@@@@@@@@@@@@@@.@..
@@@@@@@@@@@@@.@....@
@@@@@@@@@@@@@...@.@@
@@@@@@@@@@@@..@.@..@
@@@@@@@.@@.@.@.@@.@@
@@@@@@@.@@..@......@
@@@@@@@....@.@.@@@.@
@@@@@@..@@......@...
@@@@@@.@@@@.@.@.@@.@
@@@@@@...@...@..@...
@@@@@@.@..@@@..@@@.@
@@@@@...@....@.@@@.@
4
18 18 0
8 18 0
11 17 1
12 11 2

17 13 0
16 9 0
15 16 1
12 12 2
