width 20
height 20
@@@@.@@@.....@..@.@.
@@...@@@.@.@...@@...
@@@@......@..@....@@
@@.@.@@.@..@@.@.@@.@
@...@.@@..@@@...@...
.@@......@@@@@.@@.@.
....@.@@@@@@.@@...@.
@.@.@...@@@...@.@..@
@@...@@@.@.@.@.@..@@
@@@.@............@@@
@@....@@@@@.@@.@.@@@
@@@@.@.@..@..@@@.@@@
@@@@.@..@.@@@.....@@
@@@@@.@.@.@.@.@@@...
@@@@@..........@@@.@
@@@@@.@.@.@.@.@@@@@@
@@@@...@...@..@@@@@@
@@@@@.@@@@..@@@@@@@@
@@@@@@@@@@.@@@@@@@@@
@@@@@@@@@@@@@@@@@@@@
4
16 11 0
8 5 0
14 8 1
13 14 2

16 11 0
13 16 0
5 4 1
3 7 2
