width 20
height 20
@@@......@@@@@@@@@@.
@@@@.@.@.@.@@@@@.@..
@....@@.@@..@.@....@
..@@@...@@.@...@.@..
.@.@..@......@.@@..@
.....@..@@.@@@.@@@..
@.@.@..@@@@@@@...@.@
...@@@....@@@..@@..@
@.@@@@@@.@.@.@.@@@..
..@@@@@@@....@.@...@
.@@@@@@@@@.@...@@@..
@@@@@@@@@@@..@.....@
@@@@@@@@@@..@..@.@.@
@@@@@@@@@@@..@.@@..@
@@@@@@@@@@@@@..@@@..
@@@@@@@@@@@@@@@@@..@
@@@@@@@@@@@@@@@@@@..
@@@@@@@@@@@@@@@@@@@.
@@@@@@@@@@@@@@@@@@..
@@@@@@@@@@@@@@@@@@.@
4
16 6 0
14 4 0
18 1 1
13 12 2

2 4 0
16 1 0
18 1 1
17 4 2
