width 20
height 20
@.@.@.@..@@@.@@@@...
........@.....@@@@@.
@.@.@.@.@.@@.@@@@...
@@..@@.....@.@@@@@.@
@@.@..@@@.@..@@@@@..
@@..@..@.@..@@@@@@.@
@@.@@.@...@..@......
...@@..@.@@@.@@@.@.@
@.@@.@....@......@..
@@@@...@.@@@@@.@.@.@
@@@@.@@.@@@@@@.@.@..
@@@@.....@@@@..@@.@.
@@@@.@@.@@@@.@@.@.@.
@@@..@.@@...........
@@@@...@.@.@.@.@.@.@
@@@@@@.@...@@@.@@...
@@@@@..@.@@@@@...@.@
@@@@@@....@.@..@@.@@
@@@@@@@.@...@@.....@
@@@@@....@.@@@@.@.@@
15
8 19 0
9 8 0
11 1 0
1 7 0
16 14 0
4 12 0
13 1 0
2 6 0
15 19 0
7 10 0
19 11 0
3 0 0
18 0 0
12 3 0
13 13 0

18 18 0
8 5 0
4 10 0
2 1 0
18 2 0
14 14 0
7 3 0
18 15 0
8 17 0
9 4 0
4 8 0
11 1 0
16 9 0
8 15 0
8 0 0
