width 20
height 20
@@@@...@.@@@@..@....
@@@@.@...@@.@@.@.@.@
@@.@@..@.@........@@
@@..@@.@..@@.@@@.@@@
@..@@@@..@.@....@@@@
@@....@@.....@.@@@@@
@..@@.@.@.@@@@@@@@@@
@@.@.......@@@@@@.@@
@@@@@.@.@.@@@.@@@...
@@@@.@...@.@@.@@@.@.
.@@..@.@....@......@
.@.@.@..@.@.@.@.@@@.
.......@@@....@.....
@.@@.@@@@@@@.@@@.@.@
....@@@@@...@@@@@@.@
@.@...@@@@@..@@@.@..
@@@.@.....@@.......@
@.@@@.@.@@@@@@.@.@..
.....@..@@@@@@..@@@.
@@.@...@@@@@@@@@@@..
15
19 9 0
15 12 0
18 10 0
5 12 0
18 16 0
6 1 0
19 11 0
16 0 0
17 10 0
18 14 0
2 7 0
2 2 0
9 8 0
1 6 0
14 0 0

17 8 0
2 18 0
16 16 0
15 2 0
15 11 0
4 0 0
13 8 0
19 12 0
18 14 0
4 19 0
7 1 0
2 14 0
8 7 0
17 16 0
11 1 0
