width 20
height 20
..@@@@@.............
....@@........@.....
..........@.....@...
....................
@.....@.......@..@..
........@..........@
......@...........@.
.@.......@..........
.......@..@.........
....@...............
.......@..@.........
..............@.@..@
........@......@.@@@
...@..@......@.....@
....................
........@......@....
....................
.@.@................
................@...
......@@.......@....
4
0 9 0
8 11 0
6 17 0
2 16 0

1 12 0
8 11 0
16 1 0
5 4 0
