width 20
height 20
....@.......@@@@....
.......@............
..@...........@.@...
....................
....................
...@....@........@..
.....@.........@....
..........@...@.....
.......@............
..@...@.............
...........@........
....@.....@.@....@..
@@@....@.@..........
@...........@.......
......@.............
...@..........@.....
.......@............
.........@.@@.@.....
....................
.@@@@..@@...........
4
11 14 0
0 10 0
18 8 0
7 11 0

10 2 0
0 9 0
12 10 0
18 17 0
