width 20
height 20
.@.......@@@@@@.....
....................
.......@...@........
@.........@.........
@...................
@.............@.@...
....................
..@....@........@...
........@.....@.....
.@.............@.@..
@@@@@@@.......@.....
....................
..............@.@...
...@......@.........
@.....@.............
..............@.....
....................
...@@...@...........
...@@........@....@.
...@..........@.@...
4
19 0 0
9 10 0
11 6 0
18 11 0

10 18 0
1 15 0
0 19 0
15 11 0
