width 20
height 20
@@@@@@@@@@....@@@@@@
@@@@@@.@@.@.@@@@@@@@
@@@@@.........@@@@@@
@@@@..@@@.@.@@@@@@@@
@@@@@..@@..@@.@@@@@@
@@@@@@.@..@...@@@@@@
@@@@@@@@.@.@.@@@@@@@
@@@@@@@......@@.@.@@
@@@@@@@.@.@.@@......
@@@@@@@..@@...@.@@@@
@@@@@@@.@@@.@......@
@@@@@@@.@@@@..@@@.@@
@@@@@@..@@@.@....@@@
@@@@@@@.@@....@.@.@@
@@@@@@@..@.@@.@@...@
@@@@@@@@@@@@@....@..
@@@@@@@@@@@@@.@.@..@
@@@@@@@@@@@@@@@@..@@
@@@@@@@@@@@@@.@.@..@
@@@@@@@@@@@@......@@
2
18 14 0
10 14 1

11 3 0
10 14 1
