width 20
height 20
@@@@@@@@@@@.@.@....@
@@@@@@@@@@..@.@@@@..
@@@@@@@@@@@........@
@@@@@@@@@@..@@@@.@..
@@.@@@@@@.@.....@@.@
@@...@@@@...@.@.@@..
@..@@@@@@.@.@@..@..@
.@...@@@@..@.@.@@.@@
.@@@..@@@.@@..@...@@
..@@.@.@.@.@@.@.@.@@
.@...............@@@
...@@.@.@@@.@.@.@@@@
@@..@@.....@@.@@.@@@
@..@@.@.@.@@@.@...@@
..@@...@@...@...@@@@
@..@.@....@.@@@@@@@@
@.@.@.@@@@@.@@@@@@@@
.......@@@..@@@@@@@@
.@.@.@.@@@@..@@@@@@@
..@..@..@@@.@@@@@@@@
2
9 6 0
7 11 1

12 10 0
19 1 1
