width 20
height 20
.@@@@@@@@@@@.@..@.@@
.@.@..@@@.@....@...@
....@..@...@.@@..@@.
@@.@@.@.@.@...@.@...
...........@@.....@.
@.@@.@.@@@....@.@@..
@@@@@@@@@@@@.@..@@@@
@@@@@@@@@@@@@@@..@@@
@@@@@@@@@@@@@@@@.@@@
@@@@@@@@@@@@@@@@@@@@
@@@@@@@@@@@@@@@@@@@@
@@@@@@@@@@@@@@@@@@@@
@@@@@@@@@@@@@@@@@@@@
@@@@@@@@@@@@@@@@@@@@
@@@@@@@@@@@@@@@@@@@@
@@@@@@@@@@@@@@@@@@@@
@@@@@@@@@@@@@@@@@@@@
@@@@@@@@@@@@@@@@@@@@
@@@@@@@@@@@@@@@@@@@@
@@@@@@@@@@@@@@@@@@@@
2
19 3 0
18 1 1

7 4 0
1 5 1
