width 20
height 20
@@@@@@@@@@@@@@@@@@.@
@@@@@@@@@@@@.@@@@@.@
@@@@@@@@@@@...@@@@.@
@@@@@@@@@@@@.@@@@@..
@@@@@@@@@@@...@..@.@
@@@@@@@@@@.@.@@.@@..
@@@@@@@..........@.@
@@@@@@..@.@.@@.@....
@@@@@@@.@@.@@@@..@.@
@@@@@@..@....@.@.@@.
@...@..@@.@.@@......
@.@.@.@@.@..@..@.@.@
@.@......@@..@@...@@
...@.@.@....@@..@@@@
.@..@@@..@.@@@@.@@@@
@..@@...@@@@@@@@@@@@
.@..@.@..@@@@@@@@@@@
...@..@@@@@@@@@@@@@@
.@@.@.@@@@@@@@@@@@@@
....@.@@@@@@@@@@@@@@
2
14 13 0
0 13 1

18 4 0
11 11 1
