width 20
height 20
@@@@@@@@.@@@..@@@@@@
@@@@@@@......@@@@@@@
@@@@@@..@.@.@@@@@@@@
@@@@@@.@@@....@@@@@@
@@@@@@.@@@@.@@@@@@@@
@@@@@...@@@.@@@@@@@@
@@@@@@.@@@@@.@@@@@@@
@@@@@...@@@@.@.@@@@@
@@@@.@@.@@.....@@@.@
@@@@..@.@..@.@@@@@..
@@@@@.....@........@
@@@@..@.@..@.@.@.@.@
@@@..@@@..@@@@..@..@
@@@@..@..@@@...@@@.@
@@@..@.@@@@..@..@...
@@@@.....@@@..@@@@.@
@@@@@.@.@@@@.@@@@@@@
@@@@@.@@@@@@@@@@@@@@
@@@.@.@@@@@@@@@@@@@@
@@@...@@@@@@@@@@@@@@
2
6 5 0
5 10 1

11 5 0
18 12 1
