width 20
height 20
...@@.............@.
.......@..@.........
....................
....@.........@.....
............@......@
....................
....................
......@..@.....@..@.
....................
................@...
.......@............
.@..................
...........@........
............@....@..
.....@.......@......
.....@@@....@.......
.....@@@.@......@...
....@.@@....@.@....@
..................@@
..........@......@@@
9
17 12 0
7 8 0
6 6 0
9 5 1
10 6 1
8 19 1
7 18 2
6 18 2
8 11 2

6 4 0
2 10 0
13 19 0
12 5 1
10 5 1
5 12 1
3 1 2
17 6 2
1 18 2
