width 20
height 20
@@............@.....
....................
....@...............
@@.....@..@.........
@..@.........@......
@.....@@............
..............@..@..
.......@............
@........@..........
@@.........@........
@.......@....@......
....@...............
@.............@...@.
@....@@@.......@....
...@......@@........
.......@............
....................
...@..@....@.@....@.
....................
....................
9
2 18 0
8 17 0
8 1 0
2 10 1
1 15 1
8 15 1
6 3 2
18 10 2
9 9 2

14 7 0
15 15 0
18 7 0
6 9 1
5 18 1
13 6 1
1 19 2
18 10 2
12 12 2
