width 20
height 20
..............@.....
....@...............
........@..........@
....................
....................
..........@.@...@...
...@................
........@...@.......
....@.....@.........
..................@.
.@.@..@.....@.......
.....@.@......@..@..
....................
......@.@...........
.@...........@......
...@....@...........
.................@..
......@@......@.....
....@.@@............
@@....@@..@.........
6
0 0 0
17 17 0
9 11 1
19 13 1
9 9 2
11 2 2

17 12 0
16 1 0
9 9 1
9 11 1
19 19 2
19 15 2
