width 20
height 20
@@@@................
@...........@.......
........@.......@...
......@.......@.....
....................
....................
......@@.@..@.@.....
..........@..@......
....@...@...........
...............@....
..........@.........
....................
.............@......
.....@..............
....@...............
......@........@....
.........@.@.@......
....................
@...@...............
@...................
6
1 12 0
7 10 0
2 19 1
17 18 1
16 11 2
14 12 2

14 0 0
0 17 0
8 15 1
14 14 1
1 1 2
4 13 2
