width 20
height 20
..@.................
....................
@....@.@..@.........
........@......@....
...@................
....................
...............@....
@@........@@........
.........@..........
.......@.......@...@
............@...@...
....@...............
.....@...@.....@....
...@......@.@.......
.....@..............
....................
.............@.@....
...@..........@.....
......@..@.@......@@
.............@...@@@
6
8 5 0
2 17 0
18 12 1
8 11 1
14 9 2
11 15 2

5 7 0
19 2 0
3 6 1
14 0 1
13 4 2
18 9 2
