width 20
height 20
..@...@.............
................@...
..........@.........
..@........@..@.@...
..@.................
.....@.......@...@..
........@......@....
..@.................
..@......@..........
.......@...@........
.@...........@..@...
...............@....
.....@..@...........
.............@......
..@.................
....@...............
......@.............
....@...........@...
.@..................
.....@.@@@.@@....@..
6
7 5 0
14 8 0
11 11 1
2 1 1
19 17 2
9 12 2

18 18 0
18 0 0
19 19 1
4 2 1
15 8 2
6 5 2
