width 20
height 20
...@@@@@..@@@@@@@@.@
.@..@@@..@@@@@@@....
.@.@@@@@..@@@...@.@.
@..@@@@@.@.@.@.@.@@.
@.@.@@............@.
......@.@.@@.@@.@...
@.@.@.@@@.@@@@@@..@.
@.@.@.....@@@@@@@..@
@@...@.@.@@@@@@@..@@
@@@.@@.@..@.@@@.@.@.
@@@.@.@@@....@......
@@@@@...@.@.@..@@@.@
@@@.@.@@.@.@.@.@@@@@
@@.............@@@@@
...@.@@@.@.@.@.@@@@.
@@..@@@@@@@..@..@@..
@@@..@@@@@@@.@@...@.
@@..@@@@@@@@@@@.@.@.
@@@@@@@@@@@@@@@@....
@@@@@@@@@@@@@@@@@.@.
9
0 14 0
5 10 0
15 9 0
19 16 1
13 2 1
8 7 1
17 6 2
7 13 2
12 5 2

9 10 0
8 8 0
17 1 0
2 1 1
14 2 1
2 5 1
3 15 2
17 17 2
12 5 2
