width 20
height 20
.@.@.@.@@..@........
.@...@....@@@@@.@.@.
.@.@...@@..@@.@.@.@.
.@..@.@@@@.......@@@
.@.@@.@@@@.@.@@.@.@@
...@...@@@@@@@......
@.@@@.@@@@@@@@@@.@.@
...@.@@@@@@@@@...@..
@.@..@@@.@@.@@@.@@@@
...@..@...@..@@.@.@@
.@..@...@@..@.....@@
@..@..@@@..@@@.@.@@@
@@...@@...@@@@@@.@@@
@@@@....@..@@@@@@@@@
.@@.@@@@..@@@@@@@@@@
.@.......@@@@@@@@@@@
...@@.@.@@@@@@@@@@@@
@.@@@@@@@@@@@@@@@@@@
...@@@@@@@@@@@@@@@@@
@@..@@@@@@@@@@@@@@@@
9
15 7 0
15 0 0
13 0 0
18 0 1
9 1 1
9 13 1
13 2 2
11 9 2
11 8 2

5 13 0
2 3 0
1 5 0
10 3 1
14 3 1
13 3 1
15 10 2
5 2 2
7 15 2
