width 20
height 20
@@@@@@@@.@@@@.......
@@@@@@@@.@@@..@.@.@.
@@@@@@@@..@.@..@@@@.
@@@@@@@..@....@@@...
@@@@@.@@...@.@@@@@.@
@@@@..@@.@.@...@@@@@
.@@@@....@@@@.@@@@@@
..@@.@.@...@...@@@@@
@..@.@.@@@@.@.@@@@@@
@@........@.@@@@@@@@
@..@@.@.@...@@@@@@@@
..@@@@@@..@@.@@@@@@@
@.@@@@...@....@@@@@@
....@..@...@.@@@@@@@
@.@..@@..@@@@@@@@@@@
@@..@@@@.@@@@@@@@@@@
@@.@@@@@..@@@@@@@@@@
@@@@@@@@@@@@@@@@@@@@
@@@@@@@@@@@@@@@@@@@@
@@@@@@@@@@@@@@@@@@@@
9
13 1 0
19 1 0
6 9 0
10 10 1
18 3 1
0 6 1
1 7 2
2 16 2
9 9 2

1 10 0
8 3 0
13 1 0
0 13 1
8 14 1
1 12 1
19 3 2
6 6 2
2 15 2
