width 20
height 20
@@@@@@@@@@.@@.@@@.@@
@@@@@@@@@@.....@..@@
@@@@@@@@@.@@@.@.@.@@
@@@@@@@@..@...@...@@
@@@@@@@@.@.@.@.@.@@@
@@@@@@@....@.....@@@
@@@@@@@.@@...@@@.@@@
@@@@@@@.@@.@.@@@..@@
@@@@@@..@@@@@@@@@.@@
@@@@@..@.@@@..@@@.@@
@@@@.@....@@.@@@.@@@
@@@....@.@@...@..@@@
@@@@.@.@@@@@.@.@.@@@
@@@@.@...@.@......@@
@@@@@@.@....@.@@@.@@
@@@@@@@@@.@....@@..@
@@@@@@...@@@@.@...@@
@@@@@@.@...@.@@@.@@@
@@@@@@@..@........@@
@@@@@@@@@..@@@@.@.@@
9
17 16 0
16 3 0
16 10 0
14 18 1
17 14 1
13 0 1
17 2 2
13 1 2
6 10 2

8 3 0
6 10 0
9 5 0
9 15 1
17 16 1
16 18 1
5 9 2
12 10 2
16 5 2
