width 20
height 20
@@@@@@@@@@@@@@@@@@@@
@@@@@..@@@@@@@@@@@@@
@@@@..@.@@@@@@@@@@@@
@@@@@.@..@@@@@@@@@@@
@@@@@...@@@@@@@@@@@@
@@@@@@@...@@@@@@@@@@
@@@@@@@@@...@@@@@.@@
@@@@@@@@@@@..@@@..@@
@@@@@@@@.@@.@.@@@...
@@@@@@@.......@.@.@.
@@@@@@@@.@@@@......@
@@@@@@@..@....@.@@..
@@@@@@@@..@.@..@@@.@
@@@@@.@.@@@..@..@...
@@@.....@.@@@@@.@.@.
@@..@.@.@...@.@.@..@
@@@@.@....@...@.@@@@
@@....@.@.@.@.@.....
@@@.@....@@@....@@.@
@@...@.@@@@@@.@..@@@
9
6 16 0
7 5 0
11 6 0
12 9 1
6 14 1
5 18 1
7 11 2
10 15 2
15 18 2

14 13 0
4 19 0
15 11 0
7 16 1
6 1 1
3 14 1
8 11 2
15 14 2
6 16 2
