width 20
height 20
@@............@.....
................@...
.@......@..@..@...@@
....@...........@.@@
...@......@........@
....................
@........@....@.....
...............@....
..@@.....@..........
...@.......@........
....................
..............@..@..
..@..........@....@.
....@.@@..@.........
...........@.@......
....................
......@.........@...
............@.......
........@...@..@....
....................
1
19 14 0

19 7 0
