width 20
height 20
@@@...........@@....
@@@.......@.........
.....@.......@......
......@.......@.....
.................@..
........@..@........
@...........@....@..
@.............@.....
@.........@.........
@@.@................
...@...@...@..@.@...
....................
....@......@......@.
...@@........@......
...@@.@....@...@..@.
....................
...@..........@..@..
.......@............
............@.......
....................
1
11 18 0

19 0 0
