width 20
height 20
....................
.........@..........
..@.....@..@.@......
......@.............
...........@........
...@..@...@.........
..@................@
...@.@..@....@.....@
...........@.......@
......@............@
...@...............@
..................@@
..........@......@@@
.@...@.........@..@@
..@...@...@.......@@
.............@....@@
.................@@@
.......@..@...@..@@@
.................@@@
.................@@@
1
13 6 0

0 16 0
