width 20
height 20
...@............@@@@
................@@@@
.....@.@....@.......
...............@.@..
..@.......@.........
.......@............
...@..............@.
.............@......
@..............@....
@...............@...
@@.....@....@.......
....@..........@....
.....@.....@@.......
....................
........@.@.......@.
....@....@.....@....
...@........@.......
......@....@........
....................
....................
1
5 13 0

18 5 0
