width 20
height 20
.......@@.@@......@@
........@...........
....................
.@...@..............
....................
..@..@..@..@....@@..
.........@......@@..
.....@..............
@..@.........@.....@
..................@@
.........@........@@
....@............@@@
.............@.@@@@@
.....@......@@@@@@@@
.@..@.....@@@@@@@@@@
.........@@@@@@@@@@@
..@.......@@@@@@@@@@
.@..@.....@@@@@@@@@@
..........@@@@@@@@@@
..........@@@@@@@@@@
13
9 9 0
3 5 0
9 1 0
5 4 0
13 1 0
15 8 1
13 5 1
15 11 1
7 13 1
6 19 2
13 0 2
0 11 2
1 11 2

2 1 0
9 19 0
9 1 0
15 10 0
6 17 0
4 8 1
1 18 1
0 19 1
0 2 1
1 6 2
6 16 2
2 13 2
4 7 2
