width 20
height 20
......@@@@.........@
......@@............
....................
..........@...@.....
.....@...@........@.
....................
..@.................
.....@...........@@.
.......@.....@.@....
....................
....@......@@.......
.........@.@@.......
.............@......
....@...............
...........@..@..@..
....@...@.........@.
....................
.....@.....@.@......
..............@....@
..@................@
13
4 9 0
15 12 0
14 13 0
8 13 0
4 7 0
17 8 1
2 1 1
12 16 1
12 3 1
19 1 2
8 6 2
3 1 2
13 5 2

13 14 0
0 9 0
8 1 0
1 0 0
18 18 0
11 18 1
8 18 1
0 1 1
2 12 1
13 18 2
18 19 2
18 16 2
4 12 2
