width 20
height 20
@.......@.@....@....
@.......@......@....
....@......@..@....@
...................@
.......@......@.@...
......@.@...........
............@.....@.
...............@....
..@.....@...........
...@@.@....@........
.@...........@......
....@.......@.......
.........@....@.....
..@...............@.
....@...............
...@................
................@..@
.................@.@
............@.@....@
.......@............
13
9 18 0
15 19 0
5 10 0
7 0 0
9 13 0
8 10 1
2 2 1
18 5 1
12 16 1
15 12 2
13 8 2
1 12 2
12 19 2

6 10 0
12 14 0
3 10 0
12 10 0
14 6 0
5 7 1
19 15 1
11 19 1
4 8 1
15 10 2
17 10 2
19 0 2
0 2 2
