width 20
height 20
@@@@@@@@@@@@.@.@.@@@
@@@@@@@@@.........@@
@@@@@@@@.@.@.@.@@@@@
@@@@@@@@..@...@@@@@@
@@@@@@@..@.@.@.@@@@@
@@@@@@@@........@@@@
@@@@@@@@@.@.@@@..@@@
.@@@@@.@@@.@@...@@@@
..@@@...@...@@.@@@@@
.@.@@@@..@.@@@.@@@@@
....@.@@...@@...@@@@
.@@@.....@.@.@@..@@@
.@.@.@@@@.@.....@.@@
.@......@...@.@.@.@@
...@.@@.@.@..@.@@...
.@.@..@@@@@.@.....@@
@@@..@.@@...@@.@@.@@
@@.@......@@..@@@.@@
....@.@.@...@.....@@
.@@....@..@...@@.@@@
3
3 16 0
2 12 1
4 19 2

13 13 0
3 13 1
1 18 2
