width 20
height 20
@@@@.@@.@@.@...@@@@@
@@@..........@.@@@@@
@@@@@.@.@@@.@...@@@@
@@@@@@....@@@@.@@@@@
@@@@@@@@@.@@@@..@@@@
@@@@@@@.@.@@...@@@@@
@@@@@.@....@@@.@@@@@
@@@@@...@.@@@....@.@
@@@...@..@@@@@.@@...
@@.@.@..@@@@@.@@..@.
@@...@@..@@@@...@..@
@@@@..@.@..@@.@@..@.
@....@@.@.@@....@...
.@.@.@....@@@.@...@@
.@.@@@.@@...@@.@.@@@
....@.@.@.@@.@.....@
.@.@@......@.@.@@.@@
..@...@@.@.......@@@
.@@@.@@@@@.@@.@@@@@@
@@@@@@@@@@@....@@@@@
3
13 11 0
7 13 1
9 14 2

0 16 0
3 15 1
14 3 2
