width 20
height 20
@@@@@@@.@@@@.@..@..@
@@@@@@...@.@..@...@@
@@@@@..@@...@..@@..@
@@@@@@...@@...@@.@..
@@@@@@@@..@.@.....@.
@@@@@@.@.@.@..@.@...
@@@@@......@@.@@@.@@
@@@@.@.@@@.@...@.@@@
@@@@...@@...@@...@@@
@@@..@.@..@....@.@@@
@@..@.@.@@..@@.@@.@.
..@@@...@.@@...@....
.@..@.@.....@@.@@.@.
.@.@...@.@@.....@..@
.....@.@@...@@.@.@..
@@.@@....@.@.@...@.@
..@..@@.@.@@...@....
.@.@......@@@@..@.@@
.....@.@.@@@@.@..@@@
@.@.@@@...@.....@@@@
3
10 2 0
2 10 1
11 2 2

12 16 0
14 11 1
11 19 2
