width 20
height 20
@@@@@.@..@@@@@.@...@
@@.@...@..@@.....@@@
@@.@@@...@@@@.@@...@
@@.....@..@@@@@..@..
@..@.@.@@...@@@@..@.
..@...@.@.@@.@@@.@.@
@..@.@...@@...@.....
@@.@...@.@..@..@@.@@
@@@@@.@@..@.@@......
@@@@@@@@@...@..@@.@.
@@@@@@@@@.@.@@...@@@
@@@@@@@@@@@@@@@@@@@@
@@@@@@@@@@@@@@@@@@@@
@@@@@@@@@@@@@@@@@@@@
@@@@@@@@@@@@@@@@@@@@
@@@@@@@@@@@@@@@@@@@@
@@@@@@@@@@@@@@@@@@@@
@@@@@@@@@@@@@@@@@@@@
@@@@@@@@@@@@@@@@@@@@
@@@@@@@@@@@@@@@@@@@@
16
8 2 0
18 6 0
18 0 0
6 2 0
16 0 0
18 2 0
16 6 0
11 8 0
7 5 0
2 2 0
2 1 0
14 10 0
9 5 0
5 0 0
16 2 0
6 6 0

9 5 0
4 6 0
16 1 0
13 7 0
11 10 0
13 6 0
3 3 0
11 4 0
4 4 0
2 3 0
9 8 0
16 4 0
10 7 0
12 5 0
6 7 0
9 4 0
