width 20
height 20
@@@@@@@@...@@@@@@@@@
@@@@@@@@.@@@.@@@@@@@
@@@@@@@@..@...@@@@@@
@@@@@@..@.@.@...@@@@
@@@@@@@.@..@.@.@..@@
@@@@@@..@@.....@@..@
@@@@@@@.@.@@.@....@@
@@@@@@........@.@@@@
@@@@@..@@.@.@..@@@@@
@@@@@@..@..@..@@@@@@
@@@@...@@.@@@@@@@@@@
@@@..@@@@@@@@@@@@@@@
@@@@.@@@@@@@@@@@@@@@
@@@@.@@@@@@@@@@@@@@@
@@@.....@@@@@@@@@@@@
@@@@.@.@@@@@@@@@@@@@
@@@@..@@@@@@@@@@@@@@
@@@@@..@@@@@@@@@@@@@
@@@@@@@@@@@@@@@@@@@@
@@@@@@@@@@@@@@@@@@@@
16
13 9 0
9 10 0
14 3 0
12 1 0
13 2 0
12 6 0
4 14 0
7 14 0
9 7 0
9 0 0
5 8 0
9 6 0
4 11 0
14 6 0
9 8 0
10 7 0

7 5 0
9 9 0
7 9 0
8 1 0
7 14 0
5 16 0
14 5 0
5 8 0
10 4 0
7 3 0
4 12 0
6 3 0
3 14 0
4 13 0
6 15 0
6 9 0
