width 20
height 20
@@@@@@@@@@@@@@@@@@@@
@@@@@@@@@@@@@@@@@@@@
@@@@@@@@@@@@@@@@@@@@
@@@@@@@@@@@@@@@@@@@@
@@@@@@@@@@@@@@@@@@@@
@@@@@@@@@@@@@@@@@@@@
@@@@@@@@@@@@@@@@@@@@
@@@@@@@@@@@@@@@@@@@@
@@@@@@@@@@@@@@@@.@@@
@@@@@@@@@@@@@@@..@@@
@@@@@@@@@@@@@@@@....
@@@@@@@@@@@@@@@..@.@
@@@@@@@@@@@@@@..@...
@@@@@@.@@@@@@@.@.@.@
@@@@@....@@@...@....
..@...@@@.@@@.@..@.@
@...@.@....@@@.@..@@
..@@...@@@.......@@@
.@@@@@.....@.@.@..@@
...@@@.@@.@@@..@.@@@
16
12 17 0
19 10 0
4 17 0
14 19 0
14 18 0
16 16 0
16 18 0
16 11 0
15 17 0
10 18 0
1 17 0
2 19 0
9 16 0
7 18 0
14 16 0
7 14 0

18 11 0
0 15 0
13 19 0
4 17 0
16 11 0
9 15 0
14 13 0
14 19 0
3 16 0
12 18 0
16 19 0
17 14 0
9 18 0
14 12 0
11 17 0
0 19 0
