width 20
height 20
...@@...@...........
....................
.........@...@..@...
..........@.@....@..
....................
.............@......
..@.................
............@....@..
.@..@......@........
.......@.....@@..@..
....@.....@....@....
....................
..........@.........
...@...........@....
........@..@....@...
@..................@
....@...........@...
....................
.....@..............
.........@@@......@@
14
0 11 0
11 7 0
17 15 0
6 14 0
3 6 0
18 9 1
17 11 1
5 13 1
3 19 1
18 12 1
14 4 2
8 16 2
8 11 2
14 0 2

14 13 0
1 17 0
19 7 0
16 1 0
18 5 0
16 7 1
18 16 1
17 2 1
15 4 1
5 17 1
2 10 2
2 2 2
15 8 2
0 18 2
