width 20
height 20
@..............@...@
.....@..............
.........@..........
............@...@..@
...................@
....@..@.@....@....@
...............@....
....................
..........@.........
....@.@.....@.@.....
....................
.......@............
....@.......@.......
.....@.@.@..........
...........@...@....
...@...............@
..@.....@.@.@.......
....................
....................
....................
7
4 4 0
4 18 0
11 4 0
0 5 1
1 5 1
17 8 2
18 19 2

19 2 0
2 3 0
10 2 0
4 1 1
14 10 1
0 19 2
1 0 2
