width 20
height 20
..............@@@...
...@..........@.....
.........@..........
......@.............
....@...@.....@...@.
.......@.@......@..@
....................
...@................
............@..@....
................@...
....@...@...........
...............@....
...@................
@.@...@....@..@...@.
....@...@...........
................@...
........@..@.@......
..@.................
..........@..@......
........@...........
7
17 12 0
18 7 0
15 7 0
3 2 1
11 19 1
6 19 2
5 19 2

2 2 0
12 15 0
16 11 0
18 9 1
2 1 1
5 18 2
14 6 2
