width 20
height 20
.@.@@@@.@.@.@@...@@@
....@@@.....@.@.@.@@
.@.@.@.@@.@........@
.@........@.@.@@@@..
@@.@.@@.@@@@.@@@...@
..@.@@@@.@.@.@@.@@..
.@....@............@
...@@..@@.@.@.@@.@..
@@...@.@..@@.@....@@
...@@.@.@....@@@.@..
@.@.@.....@@@@@@@.@.
......@.@....@@@....
.@@.@..@@.@.@.@.@.@@
..@@.@@@.@@.........
.@.@.@....@.@@@.@.@.
......@.@@.@.@@@@@..
.@.@.@........@.@.@.
@@..@@.@.@.@@.......
.@.@....@@@@.@.@.@@.
...@.@.@@@@.....@...
7
18 13 0
11 6 0
0 0 0
8 16 0
2 4 0
13 19 0
7 11 0

4 4 0
7 16 0
5 6 0
11 0 0
15 17 0
2 4 0
13 2 0
