width 20
height 20
@@@@@@@.@@....@..@@.
@@@@.@@.@.@.@@.@..@.
.@@.........@....@..
.@.@.@@.@@@@@.@@...@
.......@.@@.@.@@.@..
.@@@.@........@.@.@.
.@@@.@.@@.@.@.@.....
@.@.@.@.@@@.@.@.@@@.
.........@.@.@...@..
@.@.@.@@.......@@@@.
...@@..@.@.@.@.@.@.@
@@.@.@..@@@@@@@@....
.....@@..@.@.@...@.@
@@@@.@.@@......@.@@@
@@........@@.@.@@@@@
@.@.@.@.@.@.@@@..@@@
.....@.@.@@.....@@@@
@.@.@..@....@.@.....
...@@.@.@@@.@@@@@.@.
@@...........@@@@@..
7
4 4 0
14 8 0
0 4 0
8 12 0
8 2 0
9 1 0
15 12 0

19 17 0
19 18 0
18 19 0
10 0 0
17 17 0
7 14 0
13 4 0
