width 20
height 20
.....@....@.........
.....@@.........@..@
@....@@.............
@............@......
..@..@...@......@..@
...........@........
.......@.......@....
....................
....................
...............@...@
..@..@...@.@..@.....
..@.................
.....@.....@......@.
.................@..
..@..@..............
.@..@...........@...
..............@...@.
.@..@.....@.........
.........@..........
....................
16
5 11 0
2 15 0
4 11 0
12 3 0
14 5 0
6 17 0
11 13 1
13 11 1
6 5 1
10 8 1
17 15 1
4 19 2
2 0 2
8 1 2
12 16 2
19 2 2

3 2 0
6 10 0
4 12 0
19 0 0
8 9 0
13 0 0
5 13 1
17 19 1
6 3 1
2 19 1
5 17 1
19 11 2
4 1 2
17 2 2
12 0 2
6 7 2
