width 20
height 20
@..............@@...
@.....@.............
@...................
@.....@.@....@......
..@...@..........@..
.............@......
.....@..@..........@
..@.....@..@.....@@@
....................
....@.........@.....
@.......@...........
................@...
............@.......
......@.............
.@......@...........
....................
............@.......
...@.......@.@......
................@...
........@...........
16
14 5 0
7 9 0
12 7 0
3 12 0
15 4 0
18 12 0
1 15 1
10 3 1
13 9 1
1 17 1
10 7 1
7 6 2
19 9 2
1 7 2
4 18 2
14 13 2

9 1 0
7 9 0
1 17 0
12 11 0
18 15 0
1 1 0
9 6 1
13 12 1
12 6 1
10 4 1
9 9 1
3 0 2
0 14 2
4 19 2
2 1 2
4 17 2
