width 20
height 20
...@@...@...@@@@@@@.
@.@.@.@@@@@..@@@@@@.
......@@@...@@@@@@..
.@.@@.@...@.@@@@.@.@
@..@@...@..@@@......
@@@@@.@..@..@..@@.@.
@.@@...@..@@.@.@@@@@
..@.@.@@@.......@@@@
@....@...@@.@@.@.@@@
@@.@...@...@.....@@@
@@@..@@.@.@@@@.@..@.
@@@.@.@...@.@@..@@..
@@@@@...@......@.@@.
@@@@@@.@@@.@@@.@....
@@@@@@..@@@@@@...@.@
@@@@@@.@@@@@@@.@@...
@@@@@....@@@@@.@..@@
@@@@@@.@@@@@@@..@..@
@@@@@@.@@@@@...@@.@@
@@@@@@.@@@@@@.@@@@@@
3
5 2 0
2 4 1
14 4 2

1 4 0
6 6 1
9 11 2
