width 20
height 20
@@@@@@@@@@@@@@@@@@@@
@@@@@@@@@@@@@.@@@@@@
@@@@@@@@@@@@...@@@@@
@@@@@@@@@@...@@@@@@@
@@@@@@@@@@@@..@@@@@@
@@@@@@@@@@@@@.@@@@@@
@@@@@@@@@@@@@.@@@@@@
@@@@@@@@@@@@@..@@.@@
@@@@@@@@@@@@.@......
@@@@@@@@@@@@.@.@.@.@
@@@@@@@@@@@...@@@..@
@@@@@@@@@@@@.@.@.@.@
@@@@@@@@@@@........@
@@@@@@@@@@@@.@@.@.@@
@@@@@@@@.@.@..@@@@@@
@@@@@@@......@.@@@@@
@@@@@@..@.@@....@@@@
@@@@@@@..@...@@..@@@
@@@@@@@.@.@.@@@@@@@@
@@@@@@.....@@@@@@@@@
3
8 19 0
15 12 1
14 16 2

13 2 0
16 17 1
18 8 2
