width 20
height 20
@@@@@..@@@......@@@@
@@@@..@.@..@.@@..@@@
@@@.@.@.@@..@@@@@@@@
@@....@....@@@.@.@@.
@.@.@@.@.@..........
.......@@..@@@@.@.@@
.@.@.@....@@@@@@..@@
.@@...@.@@@@@@@@@.@@
..@.@..@@@@@@@@....@
.@.@..@@@..@@@@@@.@@
...@@@@...@@@.@@..@@
.@@..@..@.....@@@@@@
.@.@.@@.@.@.@.@@@@@@
........@.@@...@@@@@
@.@.@.@@@.@..@.@@@@@
@..@..@.@@@@.@@@@@@@
@@..@....@@@@@@@@@@@
@..@@.@.@@@@@@@@@@@@
@@@.@@..@@@@@@@@@@@@
@@.....@@@@@@@@@@@@@
3
0 10 0
19 4 1
15 5 2

16 1 0
14 13 1
10 3 2
