width 20
height 20
@@@@@@@@@@@@@@@@@@@@
@@@@@@@@@@@@@@@@@..@
@@@@@@@@@.@@@@@..@..
@@@@@@@@..@.@@@@...@
@@@@@@@..@...@...@.@
@@@@@@..@.@.@@@.@..@
@@@@@@@......@@@.@..
@@@@@@@@.@@.@.@....@
@@@@@@@....@@.@.@.@.
@@@@.@..@@......@...
@@@....@@.@@@.@@..@.
@@@@.@.@@..@...@@.@@
@..@.@.@..@.@.@@@@@@
.@.@@...@.@...@@..@@
.@...@@@....@.@@@...
...@.@..@.@..@.@..@.
.@..@.@...@@.@.@@.@.
.@@...@@@@.........@
...@@....@.@@.@@.@@@
.@@@@@@@...@....@@@@
8
1 12 0
10 18 0
16 4 0
1 18 0
18 3 0
18 2 0
0 14 0
17 1 0

17 9 0
15 5 0
11 7 0
19 14 0
13 11 0
18 5 0
9 12 0
1 15 0
