width 20
height 20
@@@@@@@@@@@@@@@@@@@@
@@@@@@@@@@@@@@@.@.@@
@@@@@@@@.@@@@@......
@@@@@@@...@.@@.@@.@@
@@@@.@.@.@@.@...@...
@@@@.........@@@..@@
@@@@@.@.@.@.@@.@@...
@@@@...@..@.@.....@@
@@@@.@.@@@....@@.@@@
@@@@@@@@@@@.@...@@@@
@@@@@@@@@@..@@.@..@@
@@@@@@@@@@@..@...@@@
@@@@@@@@@@@@@.@@.@@@
@@@@@@@@@@@@......@@
@@@@@@@@@@@@@.@@.@@@
@@@@@@@@@@@@@.@.@@.@
@@@@@@@@@@....@....@
@@@@@@@@@@@.@...@@@@
@@@@@@@@@@...@.@@@@@
@@@@@@@@@@@.@@@@@@@@
8
16 13 0
9 7 0
8 2 0
8 7 0
11 4 0
18 2 0
14 13 0
10 18 0

5 7 0
11 11 0
13 12 0
10 16 0
4 5 0
15 11 0
15 4 0
14 10 0
