width 20
height 20
.......@...@@@@@@@@@
@.@.@@.@@.@..@@@@@@@
@..@@.....@@.@@@@@@@
..@@@@.@@......@.@@@
@.@@@..@@@.@@.@..@@@
@@.@@.@@@..@@@.@..@@
@@......@@..@@...@.@
@@.@.@@@...@@..@....
@...@@..@@.@..@@.@@.
.@@.@..@.@@@@...@.@.
.....@.....@.@.@..@.
.@.@@..@@.@......@@@
..@..@.@.@..@.@.@.@@
.@.@.@.@..@.@@......
.......@@...@@@.@.@.
@.@@.@....@@@@@.@@@@
...@.@.@@@@@@@@@@@@@
@.@@@@@@@@@@@@@@@@@@
@@@@@@@@@@@@@@@@@@@@
@@@@@@@@@@@@@@@@@@@@
8
8 12 0
0 3 0
11 12 0
17 9 0
2 0 0
13 12 0
8 2 0
16 13 0

9 13 0
3 10 0
2 10 0
2 0 0
19 9 0
12 1 0
15 15 0
16 13 0
