width 20
height 20
...@...@@@@@@@@@@@@@
.@@@@.@@@@@@@@@@@@@@
.@.@...@..@@@@@@@@@@
...@.@.@.@.@@@@@@@@@
.@....@....@@@@@@@@@
.@@@.@@@.@..@.@.@@@@
..@@@@@@@.@......@@@
.@@@@@@@..@.@@.@..@@
...@@@@@@...@@@..@.@
@.@@@@@@@.@..@.@@...
...@@@@@@@@.@@.@@@.@
@.@@.@@@@@......@...
..@...@@@.@.@.@..@.@
.@@@.@.@.....@@@....
..@......@.@@....@.@
.@.@.@@.@@..@.@.@..@
......@@@@.@@..@.@..
@@@.@@.......@....@.
@@@@...@.@.@.@.@@.@.
@@@@.@@@..@@@...@@@@
15
18 9 0
14 16 0
5 18 0
2 15 0
14 14 0
4 14 1
11 9 1
13 19 1
16 14 1
8 14 1
13 16 2
10 17 2
12 13 2
6 14 2
14 17 2

0 13 0
19 17 0
6 0 0
9 7 0
6 2 0
9 6 1
19 18 1
0 15 1
1 11 1
14 19 1
8 4 2
18 9 2
2 4 2
4 0 2
4 19 2
