width 20
height 20
@@@..@@@..@@..@.@@.@
@...@@...@.@.@......
.@.@...@.......@.@@.
...@@@..@@.@.@@@@@..
.@.....@@@@@@@@@@.@.
.@@.@.@@@@@@.@@@@...
.@@@@@@@@@@...@@@.@@
.@@@@@@@@@@@@.......
..@@@@@@@@@@@@.@@.@@
.@@@@@@@@@@.@@@@....
..@@@@@@@@....@.@.@.
.@@@@@@@...@.@.....@
.@@@@@@@@.@....@.@.@
@@@@@@@@@..@.@.@@@..
@@@@@@@@@.@@@..@@..@
@@@@@@@@@.@@.@.@.@@@
@@@@@@@@@@.......@.@
@@@@@@@@@@.@.@.@....
@@@@@@@@@...@@..@.@@
@@@@@@@@@@.@@@.@@@@@
15
0 3 0
9 14 0
14 2 0
9 0 0
17 8 0
18 5 1
14 16 1
14 17 1
4 2 1
11 10 1
7 3 2
0 12 2
16 2 2
9 13 2
8 1 2

19 3 0
8 11 0
14 14 0
18 13 0
12 6 0
15 7 1
0 10 1
19 1 1
10 16 1
13 2 1
12 0 2
18 14 2
17 1 2
12 10 2
10 19 2
