width 20
height 20
@@@@@@@@@@@@@@@@@@@@
@@@@@@@@@@@@@@@@@@@@
@@@@@@@@@@@@@@@@@@@@
@@@@@@@@@@@@@@@@@@@@
@@@@@@@@@@@@@@@@@@@@
@@@@@@@@@@@@@@@@@@@@
@@@@@@@@@@.@@@@@@@@@
@@@@@@@@@...@@@@@@@@
@@@@@@@@.@.@.@@@.@@@
@@@@@@.......@@..@@@
@@@@@@@.@@.@..@@...@
@@@@@@@@@@.@.@.@@.@.
@@@@@@@@@@@..@..@...
@@@@@@@@@@.@.@.@.@@.
@@@@@@@@@...........
@@@@@@@@@.@@.@@.@.@.
@@@@@@@@@@@@@@.@...@
@@@@@@@@@@@@@....@..
@@@@@@@@@@@.@@.@.@@@
@@@@@@@@@@.....@.@@@
15
19 11 0
15 12 0
16 8 0
12 8 0
12 13 0
18 10 1
17 16 1
13 10 1
14 17 1
13 17 1
11 14 2
11 7 2
8 9 2
10 19 2
16 10 2

19 12 0
11 12 0
16 9 0
12 8 0
13 10 0
17 15 1
9 15 1
11 18 1
9 7 1
14 11 1
11 14 2
8 8 2
12 19 2
13 14 2
17 14 2
