width 20
height 20
@@@@@@@@@@@@@@@@@@@@
@@@@@@@@@@@@@@@@@@@@
@@@@@@@@@@@@@@@@@@@@
@@@@@@@@@@@@@@@@@@@@
@@@@@@@@@@@@@@@@@@@@
@@@@@@@@@@@@@@@@@@@@
@@@@@@@@@@@@@@@@@@@@
@@@@@@@@@@@@@@@@@@@@
@@@@@@@@@@@@@@@@@@@@
.@.@@@@@@@@@@@@@@@@@
....@.@@@@@@@@@@@@@@
@.@...@@@@@@@@@@@@@@
@@@@.@@@@@@@@@@@@@@@
......@@@@@@@@@@@@@@
@@@@.@.@.@@@@@.@@@@@
@......@.@@@.@.@@@@@
..@.@.@.........@@@@
@..@....@.@.@@.@.@.@
@@.@@@@@@@..@.......
@@@@@@@@@@@.@@.@.@.@
15
3 15 0
2 15 0
8 15 0
16 19 0
4 11 0
5 13 1
4 17 1
0 16 1
18 18 1
1 16 1
18 17 2
3 10 2
11 17 2
16 17 2
6 15 2

18 19 0
14 15 0
8 14 0
16 18 0
2 10 0
1 15 1
11 17 1
18 17 1
3 15 1
13 16 1
5 17 2
12 16 2
4 12 2
7 17 2
14 17 2
