width 20
height 20
@@@@@@@.@.@.@.....@@
@@@@@@........@.@@@@
@@@@@@@@@@@.@@@..@@@
@@@@@@@@@......@.@@@
@.@@@@@...@.@.@..@@@
...@@...@.@@..@.@@@@
@.@@..@.@@@@@@@@@@@@
...@@..@.@@@@@@@@@@@
@.@@@.@@.@@@@@@@@@@@
.........@@.@..@@@@@
.@@.@.@.@.@..@....@@
@@@@@.@.....@@.@@.@@
@@...@..@.@.....@..@
...@..@..@..@.@@@.@@
@@.@.@@.@@@.@@.@...@
@..@@@.....@@@.@@.@@
@@..@@@.@@..@......@
...@.@@@...@@.@.@.@.
.@....@..@.@@@..@@@.
..@.@...@..@@@@.....
9
17 15 0
15 2 0
3 12 0
9 0 1
14 15 1
15 10 1
5 6 2
16 0 2
16 2 2

6 12 0
5 6 0
14 11 0
9 3 1
14 14 1
7 0 1
2 14 2
15 0 2
16 19 2
