width 20
height 20
...........@........
.....@...........@..
.............@......
.........@..........
....................
........@......@....
........@.......@...
.@.@....@...........
.................@..
.......@............
...@.......@...@....
..............@.....
....................
.@....@.@...........
..........@...@.....
...........@....@...
....@...............
..@.....@...........
....................
...@@@.............@
2
2 0 0
7 13 0

16 18 0
16 5 0
