width 20
height 20
....................
@................@..
..@...@.............
......@.............
....@...........@...
@@......@...........
@@.@..........@@....
@@.....@.@..@.......
...@................
.@............@...@.
............@.......
..................@.
.....@......@..@....
..@..............@..
............@.......
...............@....
........@...........
.............@......
....................
....................
2
13 6 0
7 19 0

7 19 0
3 3 0
