width 20
height 20
....................
....@..@....@......@
.....@.....@....@...
..................@.
..............@.....
..@.....@...@.......
.......@.........@..
............@.......
........@...........
..@...........@.....
......@..@.@.....@..
..@...............@@
.....@........@...@@
..........@....@..@@
.........@..........
...@................
..........@.....@...
........@.....@.....
....@...............
....................
2
16 7 0
14 18 0

4 7 0
6 16 0
