width 20
height 20
@........@..........
....@..........@....
....@...........@...
...............@....
......@..@..........
............@.......
....................
...@...@..@....@.@..
..@.........@.......
...@................
@....@..@.........@.
@............@.@....
.....@.@.@..........
@...............@...
..........@.........
.........@...@.@....
......@.@...........
...............@....
...........@........
...........@@.......
2
18 11 0
9 18 0

18 9 0
8 19 0
