width 20
height 20
...................@
.........@.@.......@
..........@.........
...@...@.........@..
..@.@.@.............
..........@.........
....................
..@...@.@.@.....@...
....@.......@.....@.
.....@..............
........@..@..@...@.
.............@......
..............@.@...
.....@......@.......
................@...
@...................
........@...@...@...
......@.............
.....@.........@....
............@@@@....
2
18 19 0
8 8 0

19 19 0
16 19 0
