width 20
height 20
........@...........
....................
....................
...@..........@.@...
..........@.........
...@......@.........
........@....@..@...
.@.....@.........@..
.....@....@..@......
@@..................
...@...@......@.....
................@...
.....@......@.......
..@..@..............
....@......@.@.@....
....................
..............@.....
....@.@...@.......@@
.........@........@@
......@...........@@
3
11 10 0
13 3 1
6 6 2

11 10 0
5 15 1
7 15 2
