width 20
height 20
@...................
...@..@.............
...................@
.....@.........@....
.........@..@....@.@
...@.......@........
..@..........@...@..
........@.@.@.@.....
....@.@.............
....................
.....@......@...@...
........@.....@.....
.......@.........@..
...................@
.........@...@....@@
......@.@....@......
................@...
....@......@......@.
....................
...............@....
3
7 11 0
1 16 1
3 16 2

1 12 0
4 6 1
10 15 2
