width 20
height 20
....................
....................
...@....@...........
..@........@.@...@..
.@..................
..@.@..@.......@....
....................
...............@....
..@...@.....@.......
.@......@...........
...@....@.........@.
...@.@....@...@.....
...@..@.........@...
.................@..
..................@.
.......@.......@....
..................@.
.............@......
....................
...............@...@
3
7 19 0
18 0 1
18 9 2

5 19 0
9 0 1
10 3 2
