width 20
height 20
....@@@......@..@@@@
..@.@@@......@@..@@@
......@....@.@@....@
................@...
.......@............
.@..........@.@.....
.....@..............
@..@.......@..@.....
...............@.@..
.....@.@............
.@.@..........@.....
....................
.......@@....@......
...@................
@..........@...@....
............@......@
.@.................@
......@..@..........
.....@...@..........
.@.......@@...@@....
11
2 18 0
5 8 0
19 17 0
2 0 0
18 7 1
5 19 1
0 13 1
18 19 1
7 11 2
18 15 2
14 8 2

19 19 0
4 12 0
19 18 0
4 4 0
17 7 1
12 16 1
2 16 1
9 0 1
10 1 2
18 14 2
10 8 2
