width 20
height 20
@@@...@@@@.@.......@
@..@@...@...@.@@@.@@
..@@@.@@@@@...@@..@@
@.......@@..@.@@@...
@.@.@@@@...@.@....@@
...@@@@@@@...@@@@...
@.@@@@@@@@@@....@.@.
..@@@@@@.@.@@.@@.@@@
@..@@@@@.@..@....@@.
..@@@@@....@..@@....
.@.@.@.@@.@.@.@@.@@@
..............@..@.@
@@.@.@.@@.@.@@.@....
....@.@@@..@@...@@@.
@@.@@.....@@@.@...@.
@..@@@.@@..@..@.@...
.@.@.....@@@@.@@@.@@
.@.@.@.@.@.@@@..@@@@
...@@@@@.......@@@@@
@.@@@@@..@@.@.@@@@@@
1
12 18 0

5 3 0
