width 20
height 20
@@@@@@@@@@@@@@@@@@@@
@@@@@@@@@@@@@@@@@@@@
@@@@@@@@@@@@@@@@@@@@
@@@@@@@@@@@@@@@@@@@@
@@@@@@@@@@@@@@@@@..@
@@@@@@@@@@@@@@@@@@..
@@@@@@@@@@@@@@@@@@.@
@@@@@@@@@@@@@@..@...
@@@@@@@@@@@@...@.@.@
@@@@@@@@.@@@@@...@..
@@@@@@@@.@@@@@@@...@
@@@@@@@...@@@@@..@.@
@@.@@...@..@@@.@.@@.
@..@..@@@@.@@.......
.@.@.@@.@.@.@.@@@.@.
................@@..
.@.@.@.@@.@@@.@..@@@
..@@@...@.@@..@.@@@@
@@@@@@.@@@@@.@@@@@@@
@@@@@@@@@@@@@@@@@@@@
1
18 11 0

5 15 0
