width 20
height 20
@@@@....@@@@@@@....@
@@@.@.@@.@@@@@.@.@..
................@@@.
@@@@.@.@@@@@.@@..@..
@@@.@.@@..@.@...@.@.
@@....@..@....@.....
@.@.@..@..@.@@..@.@@
@...@.@@@.@@...@@@@@
@@.@@..@@..@.@..@@@@
@..@..@.@.@..@.@.@@@
.@.@@.......@@.@..@@
.....@.@@@@..@.@.@.@
.@.@@@@@@@@@.@.....@
..@.@...@....@.@.@@@
@...@.@..@@.@.@@...@
..@.@@@.@@.....@.@@@
@.@.....@@@.@.@.....
...@.@@.@@@@@..@.@.@
.@@@@@@@@@@@@@.@@...
@@@@@@@@@@@@@..@..@.
1
11 15 0

3 16 0
