width 20
height 20
@@@@@@@@@@@@@@@@@@@@
@@@@@@@@@@@@@@@@@@@@
@@@@@@@@@@@@@@@@@@@@
@@@@@@@@@@@@@@@@@@@@
@@@@@@@@@@@@@@@@@@@@
@@@@@@@@.@@@@@@@@@@@
@@@@@@@...@@@@@@@@@@
@@@@@@@@.@@@@@@@@@@@
@@@@@@@..@@@@@@@@@@@
@@@@@@@.@..@@@@@@@@@
@@@@@@....@@@@@@@@@@
@@@@@@@.@..@..@@@@@@
@@@@@@@@@.@.@..@@@@@
@@@@@@@@@.....@@@@@@
@@@@@@@.@.@.@....@@@
@@@@@@.....@..@.@.@.
@@@@@@@.@.@@@@....@.
@@@@@@@@...@@@@.@.@.
@@@@@@@@@@.@@@@@....
@@@@@@......@@@@@.@@
1
8 10 0

15 15 0
