width 20
height 20
@@@@@@@@@@@@...@@@@@
@@@@@@@@@@@..@@..@.@
@@@@@@@@@@.@....@@.@
@@@@@@@@@@...@@@@..@
@@@@@@@@@@.@@@.@.@..
@@@@@@@@...@@.....@.
@@@@@@@@@@.@.@.@@...
@@@@@@@@........@.@@
@@@@@@@@@.@@.@.@@@@@
@@@@@@@@@@@@.@..@@@@
@@@@@@@@@@@@@..@@@@@
@@@@@@@@@@@@@@..@@@@
@@@@@@@@@@@@@@.@..@@
@@@@@@@@@@@@@@..@..@
@@@@@@@@@@@.@@.@..@@
@@@@@@@@@@@......@.@
@@@@@@@@@@.@.@.@.@..
@@@@@@@@@....@@@...@
@@@@@@@@..@.@@@@@.@@
@@@@@@@@@..@@@@@@@@@
6
16 15 0
14 16 0
18 17 0
14 5 0
13 0 0
9 8 0

18 4 0
14 15 0
12 6 0
8 5 0
13 0 0
9 8 0
