width 20
height 20
@@@@@@@@@@@@@@@@@@@@
@@@@@@@@@@@@@@@@@@@@
@@@@@@@@@@@@@@@@@@@@
@@@@@@@@@@@@@@@@@@@@
@@..@@@@@@@@@@@@@@@@
@.@..@@@.@.@@@@@@@@@
@...@.@.....@@@@@@@@
@.@@....@.@@@@@@@@@@
....@.@.@@@@@@@@@@@@
@.@..@..@@@@@@@@@@@@
...@@@@.@@@@@@@@@@@@
@@..@@....@.@@@@@@@@
.@.@.@@@@...@@@@@@@@
.....@...@@..@@@@@@@
@.@@.@@.@.@.@@@@@@@@
....@.@......@@@@@@@
@.@.....@.@.@@@@@@@@
@@..@.@@..@@@@@@@@@@
@@@..@...@@@@@@@@@@@
@@..@@.@.@@@@@@@@@@@
6
6 13 0
7 6 0
1 13 0
3 11 0
11 12 0
2 11 0

3 4 0
2 11 0
6 16 0
7 7 0
8 17 0
1 14 0
