width 20
height 20
@@@@@@@@@@@.@.......
@@@@@@@@@@...@.@@@@.
@@@@@@@@@..@@@.@@...
@@@@@@@@@@.@...@..@@
@@@@@@@@@....@..@...
@@@@@@@@@@.@.@@@.@@.
@@@@@@@@@.@......@@.
@@@@@@@@@.@.@.@@.@.@
@@@@@@@@@.@@@@.....@
@.@@.@.@...@.@.@.@..
@.@@....@.@...@..@.@
...@.@@.....@..@@...
@@....@.@@@@..@@@.@.
@@.@@.@@@..@@.....@.
...@@.@@@.@.@.@.@..@
@@.@.@@.....@.@@..@@
.....@.@@.@@@@@@@..@
.@@.@.....@@@@@@@.@@
@@....@@@@@@@@@@@@@@
@@@.@..@@@@@@@@@@@@@
6
17 3 0
19 9 0
16 6 0
12 9 0
18 7 0
3 12 0

16 5 0
17 12 0
10 1 0
6 19 0
19 4 0
9 14 0
