width 20
height 20
@@..@.@@@.@.@@@@@@@@
@.@..........@@@@@@@
@...@.@.@@.@@@@@@@@@
.@.@@@.@.@...@@@@@@@
....@......@...@@@@@
@@.@..@@.@@..@@@@@@@
....@..@@@@@.@@@@@@@
@@@@..@..@@@@@@@@@@@
....@...@@@@@@@@@@@@
.@.@.@.@@@@@.@@@@@@@
@@...........@@@@@@@
@..@.@.@.@.@..@@@@@@
@@.@..@@@..@.@@@@@@@
@@.@.@@@@@..@@@@@@@@
@@@@@@@@@@@@@@@@@@@@
@@@@@@@@@@@@@@@@@@@@
@@@@@@@@@@@@@@@@@@@@
@@@@@@@@@@@@@@@@@@@@
@@@@@@@@@@@@@@@@@@@@
@@@@@@@@@@@@@@@@@@@@
6
4 11 0
11 1 0
10 2 0
7 10 0
6 8 0
13 11 0

10 11 0
10 4 0
12 12 0
8 10 0
2 4 0
2 10 0
