width 20
height 20
@@@@@@@@@@@@@@..@@.@
@@@@@@@@@@@@@@@.....
@@@@@@@@@@@@.@.@.@.@
@..@@@@@@@@....@@...
.@..@@@@@@@@@.@@.@.@
..@...@@@@.....@....
.@.@.@.@...@.@...@.@
.@.....@.@..@@@.@...
.@.@.@...@.@.....@.@
...@@@.@.@@.@.@.@@..
.@...@..@.@.@..@.@@@
..@@@@@@......@.....
@@@..@@@.@@.@...@@@.
@@@@..@@...@@@.@@@@@
@@.@.@@@@.@.@@@@@@@@
@@...@@@@...@@@@@@@@
@.@@.@.@..@..@@@@@@@
.........@@@@@@@@@@@
.@.@.@@@..@@@@@@@@@@
@@@@.@@@.@@@@@@@@@@@
10
0 7 0
13 12 0
0 10 0
13 4 0
18 9 0
16 11 0
4 6 0
18 8 0
11 7 0
8 18 0

4 6 0
1 5 0
10 6 0
16 4 0
8 17 0
10 7 0
4 17 0
2 18 0
3 12 0
16 10 0
