width 20
height 20
@@@@@.@.@@@@...@@@@@
@@@@.......@@@..@@@@
@@@@@@.@.@....@..@@@
.@@@.@.@@@@@.@@.@.@@
..@@.....@...@....@@
@....@.@.@@.@.@@@..@
..@.@...@.....@@@@.@
@@...@.@.@.@@..@....
@@@@.@...@@...@@.@.@
@@@...@@@.@@.@.@..@@
@@@@.@@@..@......@.@
@@@@.....@..@@.@....
@@@@@@.@@@@@....@@.@
@@@.@.@@.@.@.@@@....
@@..@.@......@@@@@.@
@@@.....@.@.@@@@@...
@@@@@.@.@..@@@@@@@.@
@@@@@@..@.@@@@@@@@.@
@@@@@@@.@..@@@@@@...
@@@@@@..@.@@@@@@@@.@
10
7 0 0
9 16 0
12 4 0
6 2 0
7 6 0
12 10 0
3 6 0
18 6 0
10 16 0
5 1 0

15 4 0
10 13 0
9 14 0
11 6 0
12 9 0
6 8 0
8 8 0
18 5 0
4 15 0
11 4 0
