width 20
height 20
@@@@@@@@@@@@@@@@@@@@
@@@@@@@@@@@@@@@@@@@@
@@@@@@@@@@@@@@@@@@@@
@@@@@@@@@@@@@@@@@@@@
@@@@@@@@@@@@@@@@@@@@
.@@@@@.@@@@@@@@@@@@@
..@.@@..@..@@@.@@@@@
@....@.@@@.@...@@@@@
..@.@@..@....@..@@@@
@@.....@@.@@@.@.@@@@
@@.@.@.@@...@....@@@
@@..@...@.@.@.@.@@@@
@.@@.@.@.@.@...@@@@@
...........@.@@@@@@@
.@@@@.@.@@....@@@@@@
..@@..@.@@.@.@@@@@@@
@.@..@@.@.@...@..@@@
...@...@...@@...@@@@
@.@@@.@@@@....@@@@@@
@.@@@@@@@@@.@@@@@@@@
3
4 15 0
15 17 0
1 8 0

5 9 0
15 16 0
1 8 0
