width 20
height 20
@@@@..@...@@@.@@@@@@
@@@@.@.@@......@@@@@
@@@.......@.@.@.@@.@
@@.@.@.@.@.@@.......
@@.@@..@@@...@@@.@.@
@...@@@.@..@@.....@@
.@.@@.....@@@.@@.@@@
.@..@@.@@..@.@....@@
..@..@.@.@.@...@.@@@
.@..@@.@.@@.@@..@@@@
..@.@..........@@@@@
.@...@.@.@.@@.@@@@@@
...@@@@@.@@..@.@@@@@
.@........@@.....@@@
..@.@@.@.@.@.@@@.@@@
.@@@@.@.........@@@@
.@@@..@@@.@.@@.@@@@@
..@.@.@@@@@@.@..@@@@
.@.....@@@@....@@@@@
...@@.@@@@@@.@..@@@@
3
6 14 0
14 5 0
5 4 0

14 12 0
16 5 0
6 4 0
