width 20
height 20
@@.@@@...@.@@.@@@@@@
@...@..@......@@@@@@
@@.@.@.@.@@.@@@@@@@@
@......@...@@@@@@@@@
@.@.@.@@.@@.@@@@@@@@
@@@@...@@@@..@@@..@.
@@@@@.@.@...@...@...
@@@@..@.@.@...@@@@.@
@.@.@....@@.@@.@.@..
@.@...@@@..........@
....@.....@.@.@.@@.@
@@@..@@.@.@@@@@@@@..
@@@.@...@..@@@@@@@@@
@@@@..@..@.@@@@@@@@@
@@@@.@..@..@@@@@@@@@
@@@@@@@.@@.@@@@@@@@@
@@@@@@@@@@@@@@@@@@@@
@@@@@@@@@@@@@@@@@@@@
@@@@@@@@@@@@@@@@@@@@
@@@@@@@@@@@@@@@@@@@@
3
18 11 0
3 11 0
5 8 0

12 5 0
9 10 0
16 5 0
