width 20
height 20
@@@@@@@@.@@.@@@@@@..
@@@@@@......@@@@@@.@
@@@@@@@@.@@..@@@@...
@@@@@@@@@...@.@@.@@.
@@@@@.@@@@@.........
@@@@@..@@@@@.@@@.@@@
@@@@..@@@@@@.@....@@
@@@@.@@@@@@@@@@.@@.@
@@@@...@@@@@.@......
@@@@@.@........@.@.@
@@@@..@@.@@@.@@.@...
@@@@@....@.......@.@
@@@@@@.@.@@.@.@.@.@@
@@@@@@@@@...@.@.....
@@@@@@@@@@.@@.@@.@.@
@@@@@@@@@@@@@@@@@...
@@@@@@@@@@@@@@@@@@.@
@@@@@@@@@@@@@@@@@@@@
@@@@@@@@@@@@@@@@@@@@
@@@@@@@@@@@@@@@@@@@@
3
10 9 0
15 11 0
17 2 0

16 4 0
19 3 0
13 12 0
