width 20
height 20
@@@.@@@@@@@@@@@@@@@@
@@..@@@@@@@@@@@@@@@@
.@.@@@@@@@@@@@@@@@@@
....@@@@@@..@@@@@@@@
@.@...@@@@.@.@@@@@@@
@@..@@.@@.....@@@@@@
@@@......@.@.@@@@@@@
@...@@.@.@@@..@@@@@@
@@@.@.@.@....@@@@@@@
@@........@@.@@@@@@@
@.@.@.@.@..@@@.@@@@@
@...@@.@@.@.....@@@@
@@@....@@.@@@@.@@@@@
@@@.@.@...@.@...@@@@
@@@.@@..@....@.@..@@
@...@@@..@.@...@@.@@
@.@.@@@@@@@..@..@..@
...@.@@@@@@@@@@...@@
@.@@.@@@@@......@.@@
@....@@@@@@.@@.@....
6
16 19 0
5 10 0
10 15 0
6 5 0
4 4 0
2 19 0

4 18 0
3 9 0
11 14 0
9 12 0
9 10 0
1 18 0
