width 20
height 20
@@@@@@.@.@.@.@.@@@@@
@@@@@@..........@.@@
@@@@@..@@.@.@@@.....
@@@@@@.@...@@@.@.@@@
@@@@@@@..@@@@.....@@
@@@@@@.@...@..@.@@.@
@@@@@..@@.@.@.@@....
@.@@@@.@@@@......@.@
.....@..@...@@@@.@..
@@.@...@..@.@@@@@.@.
...@.@..@@.@.@@@@...
.@@.@.@...........@.
@.@...@.@.@@.@.@.@..
@...@.@..@.@@@@@@..@
@.@.@@..@...@@....@@
..@..@.@.@.@.@@@@.@@
@..@.@.@......@@@@@@
..@@@....@@@.@@@@@@@
@..@.@.@..@@@@@@@@@@
@@......@...@@@@@@@@
6
10 1 0
3 14 0
7 12 0
9 2 0
1 16 0
6 0 0

10 13 0
14 7 0
3 14 0
19 9 0
12 7 0
8 1 0
