width 20
height 20
@@@@@@@@@@@@@@@@@@@@
@@@@@@@@@@@@@@@@@@@@
@@@@@@@@@@@@@@@@@@@@
@@@@@@@@@@@@@@@@@@@@
@@@@@@@@.@@@@@@@@@@@
@@@@@@....@@@@@@@@@@
@@@@@@@.@....@@@@@@@
@@@@@@@@..@@..@@@@@@
@@@@@@@@@...@..@@@@@
@@@@@@@...@.@.@@@@@@
@@@@@@@@@.@@....@@@@
@@@@@@@@@.@@@.@..@@@
@@@@@@@@...@@..@@.@@
@@@@@@@@@.@.@@@....@
@@@@@@@@.....@.@@.@@
@@@@@@@@@@@.@......@
@@@@@@@@@.....@@.@@@
@@@@@@@@.@.@@.@..@@@
@@@@@@......@..@..@@
@@@@...@.@.@@@@@@.@@
6
14 18 0
17 18 0
17 13 0
9 10 0
9 6 0
9 14 0

13 9 0
8 5 0
15 13 0
14 12 0
8 19 0
12 10 0
