width 20
height 20
..@@................
........@...........
....@....@....@.....
.............@......
..........@......@..
..@.@...............
........@..@........
.....@..............
................@...
...@.......@....@...
.............@......
...@........@.......
........@...........
@....@..............
@...........@.....@.
@@.......@@.@@......
@........@@.........
@...................
.....@....@.@.......
....................
10
9 0 0
17 13 0
12 12 0
3 5 0
18 15 1
0 8 1
14 12 1
6 5 2
4 0 2
6 16 2

3 17 0
1 2 0
2 4 0
3 5 0
14 11 1
15 8 1
12 12 1
14 15 2
14 14 2
2 14 2
