width 20
height 20
...@.......@@.......
@@..................
@............@.....@
@..@.....@.........@
..@...@@....@.......
....@...........@...
..............@...@.
......@..@..@.......
...........@..@.....
........@...........
...@.....@........@@
..................@@
..@........@........
.......@.@..........
.....@.......@......
@.............@.....
..........@.........
...@................
.......@............
@..................@
10
16 17 0
18 14 0
11 16 0
6 19 0
0 18 1
16 0 1
14 16 1
4 19 2
0 12 2
0 6 2

10 1 0
1 0 0
0 0 0
18 12 0
8 15 1
12 15 1
16 10 1
0 4 2
15 15 2
13 17 2
