width 20
height 20
@@@....@...@@@@@@@@@
@@@@.@..@@..@@@@@@@@
@@@@@@.@...@@@@@@@@@
.........@.@@@@@@@@@
@@.@@.@@@@...@@@@@@@
..@@.@.@...@...@@@@.
.@.....@.@..@.@.@...
..@.@@....@..@@..@.@
@..@..@.@.@.@.@@.@..
@.@.@.@@@.@@......@.
.............@@.@...
.@@@@@.@.@.@..@..@@.
@..@@@.@@.@..@..@@..
@.@.@......@@@@.@..@
......@@.@@@....@@.@
@.@.@.@@@..@.@@@@...
@@@..@.@.@...@..@@.@
@@@@@......@..@.....
@@@@@@.@.@..@.@.@.@.
@@@@@@..@..@@@...@..
7
8 17 0
6 17 0
0 3 0
12 17 1
9 0 1
8 10 2
8 11 2

8 14 0
10 18 0
0 3 0
12 16 1
13 6 1
9 7 2
9 17 2
