width 20
height 20
@@@@@@@@...@@..@@@@@
@@@@@@.@.@..@@.@@@@.
@@@@...@@..@...@@@@.
@@@.@.@..@...@@.@@@.
@@@.....@@@@..@..@@.
@@@.@.@@@@@@@...@.@.
@@..@.@...@@@.@.....
@.@.@..@.@.@.@@.@.@@
....@@@......@.@@...
.@@.@.@@.@.@....@.@@
@.........@.@.@.@...
@.@.@.@.@@@.@.@@@@.@
...@.@@.@@@.@......@
@@...@@@@.....@.@.@@
@@@.@.@.@@@@@.@@.@@@
@...@.....@@......@@
@@@...@.@..@@.@.@@@@
@@@@.@@@..@@@@...@@@
@@@@@@@@@.@@@.@.@@@@
@@@@@@@@@@@@@...@@@@
7
16 6 0
7 6 0
15 4 0
11 3 1
3 13 1
16 12 2
3 9 2

7 11 0
12 9 0
2 13 0
11 1 1
11 3 1
10 7 2
8 1 2
