width 20
height 20
@@@@@@@@@@@@@@@@@@@@
@@@@@@@@@@@@@@@@@@@@
@@@@@@@@@@@@@@@@@@@@
@@@@@@@@@@@@@@@@@@@@
@@@@@@@@@@@@@@@@@@@@
@@@@@@@@@@@@@@@@@@@@
@@@@@@@@@@@@@@@@@@@@
@@@@@@@@@@@@@@@.@@@@
@@@@@@@@@@.@@.@..@@@
@@@@.@@@@......@..@@
@@@..@@@@@.@.@...@@@
@@@@..@@@@@@@..@@@@@
@@@..@@@@@.@.@.@@@@@
@@@.@.@.@.......@.@@
@@........@.@.@.....
@@@.@.@.@.@@.@..@@.@
@@@..@@@.....@.@@@@@
@@@@@@@..@@@.@@@@@@@
@@@@@@@@.@@@@@@@@@@@
@@@@@@@@@@@@@@@@@@@@
7
14 13 0
12 16 0
3 14 0
10 13 1
9 16 1
5 14 2
5 11 2

3 14 0
4 9 0
12 16 0
7 15 1
14 12 1
13 8 2
4 12 2
