width 20
height 20
@@@@@@@@@@@@@@@.@...
@@@@@@@@@@@@@@@..@.@
@.@@@@@@@@@@@@@@....
...@@@@@@@@@@@@..@.@
@.@.@.@@@@@@@@@.@.@.
@.@.@.@..@@@@@@.....
@.......@@@@@@@@.@@.
.@.@.@@..@@@@@@@@.@.
....@...@@@@@@@@....
@@.@@@.@.@@@@@@@.@@@
.@..@.@@.@@@@@@...@@
..@.......@@@@@.@@@@
@.@.@@.@@.@@@@@.@@@@
.....@..@...@...@@@@
@.@.@@@@..@...@..@@@
...@@@.@.@@@.@..@.@@
.@.@@@.....@..@.....
..@@@@@@.@.@.@@@.@@.
.@@@@@@@.@@@@@@@@@@@
...@@@@@@@@@@@@@@@@@
7
2 6 0
15 0 0
2 19 0
6 6 1
8 9 1
15 11 2
13 13 2

16 1 0
3 10 0
10 13 0
15 1 1
19 5 1
3 13 2
8 18 2
