width 20
height 20
@......@..........@.
.@.@...@............
........@...........
....@......@........
..@...........@.....
@.............@.....
.@.............@....
....@......@........
@...................
@....@.....@........
...@...........@....
...............@....
.......@....@.......
...@............@...
....@...............
.....@.....@......@.
...@............@...
......@.............
...@........@.......
...@...@............
4
1 3 0
18 17 0
1 18 0
19 9 0

18 17 0
18 19 0
9 16 0
19 4 0
