width 20
height 20
....................
....@.@...@.@.......
.........@..........
.......@............
....................
..@....@............
....@........@......
...........@....@...
....................
....................
..............@..@..
.........@.........@
...........@.......@
......@.@..........@
..............@....@
@@..@...............
@@....@....@..@.....
@@.....@.....@......
@@..................
@...................
9
4 7 0
3 14 0
19 4 0
7 19 0
7 10 0
5 9 0
18 12 0
2 10 0
16 4 0

13 19 0
0 2 0
17 11 0
12 13 0
15 0 0
9 14 0
2 2 0
10 10 0
15 14 0
