width 20
height 20
...................@
............@......@
.....@..............
.......@..........@@
...@........@.@....@
..........@....@....
.@..................
.....@..@...........
....................
..................@.
......@.............
@...@......@.@...@..
...@........@.......
........@...........
.................@..
......@.............
.........@...@@.....
...@.............@..
............@.......
....................
9
1 9 0
9 2 0
12 6 0
4 7 0
12 13 0
1 0 0
3 18 0
7 1 0
15 8 0

2 10 0
10 3 0
2 17 0
17 18 0
12 14 0
1 0 0
18 14 0
5 0 0
11 8 0
