width 20
height 20
...@@@.@@@@......@@@
.......@@@@.@..@.@@.
@.......@@@@@.......
......@.........@...
...........@........
.........@......@...
....................
@......@.....@......
..@.....@.......@...
..@.@...............
.....@..@.@..@......
...@..@.........@...
....................
..@.........@.@.....
......@.........@...
..@...........@..@..
.........@........@.
........@..@........
.....@.....@........
@@..................
9
13 1 0
4 10 0
9 6 0
15 4 0
14 14 0
18 12 0
12 6 0
12 11 0
13 11 0

13 3 0
4 10 0
14 8 0
11 5 0
18 5 0
3 1 0
17 16 0
12 11 0
4 19 0
