width 20
height 20
....@@@..........@.@
...@................
...........@........
....................
........@.......@...
...@................
...@.........@..@...
.......@.......@.@..
@.........@.........
.................@..
@.@..@..@.@.@.......
@...............@...
..............@.....
.....@.............@
...........@...@...@
...@.............@.@
..@..@..@.......@..@
............@......@
..................@@
............@.....@@
9
11 8 0
8 15 0
0 4 0
5 7 0
6 19 0
17 19 0
9 7 0
14 14 0
8 15 0

0 18 0
17 19 0
1 12 0
0 7 0
11 9 0
19 11 0
1 19 0
14 5 0
8 0 0
