width 20
height 20
@@@@@@@@@@@@@@@@@@.@
@@@@@@@@@@@@@@@@@@..
@@@@@@@@@@.@@.@@@..@
@@@@@@.@........@@..
@@@@@@...@.@.@.@@.@.
@@@@@@@@..@@..@@@...
@@@@@@@..@.@@@@@..@@
@@@.@@.@.....@@@@.@@
.@.......@.@@@@@@..@
...@@.@.@...@.....@.
.@.@@@@@@.@@..@.@...
@@@@@@@....@.@.@@.@.
@@@@.@@@@.@@@..@@.@@
@@@.........@@.....@
@@@@.@@@@.@.@@@.@@.@
@.@@@@@@@@..@..@.@..
..@@.@@@..@..@...@.@
.@....@..@@@...@....
...@@@.@.....@..@.@@
@@.......@.@.@.@@@@@
12
17 13 0
13 2 0
17 4 0
12 3 0
10 15 0
4 16 0
17 10 0
16 15 0
18 14 0
4 13 0
14 11 0
14 19 0

17 18 0
8 4 0
16 16 0
13 3 0
17 4 0
6 4 0
8 18 0
1 16 0
17 11 0
17 2 0
16 15 0
14 17 0
