width 20
height 20
.@@@.@@@@@...@@@@@.@
.....@@@@.@.@@@@@...
@.@@.@@@.....@.@@@.@
@.@.@@@@@@.@@@.@...@
....@@@@@........@@@
@@@.@@.@@@.@.@.@.@..
@@......@...@@@.@@.@
@.@.@.@@@@.@@@......
....@@.@@@..@.@@@.@@
@.@@...@@..@@.@.@..@
@..@.@@.@@.@......@.
@@.......@.@.@.@@...
@@.@.@.@.....@..@@.@
@@@@@@@..@@.@@@..@..
@@@@@@@@...@.@.@@@@.
@@@@@@@@.@...@..@@@@
@@@@@@....@@...@.@@@
@@@@@@@@.@@@.@...@@@
@@@@@@@@@@@.@..@@@@@
@@@@@@@@@@....@@@@@@
12
16 16 0
11 12 0
6 12 0
2 10 0
7 13 0
1 4 0
6 16 0
7 6 0
4 1 0
9 4 0
8 14 0
17 10 0

15 9 0
0 4 0
18 13 0
3 5 0
18 0 0
12 14 0
8 12 0
6 11 0
12 12 0
10 11 0
9 14 0
4 0 0
