width 20
height 20
@@@@@@@@@@@@@@@@.@..
@@@@@@@@@@@@@@@..@.@
@@@@@@@@@@@@@@@@....
@@@@@@@@@@@@@@@@@@.@
@@@@@@@@@@@@@@@@@..@
@@@@@@@@@@@@@.@@.@..
@@@@@@@@@@@@@......@
@@@@@@@@@@@...@.@@..
@@@@@@@@@@.@@.@..@.@
@@@@@@@@@......@@@@.
@@@@@@@@@@.@@.@@.@..
@@@@@@@@@@@.@.....@.
@@@@@@@@@@@.@.@@@...
@@@@@@@@......@@..@.
@@@@@@@@@.@.@@.@.@..
@@@@@@@@@@.....@@@@.
@@@@@@@@@@@.@.@@@.@.
@@@@@@@@@@@@...@@...
@@@@@@@@@@@@@.@@@@.@
@@@@@@@@@@@@@@@@@@@@
12
16 14 0
19 2 0
18 4 0
17 12 0
18 2 0
14 9 0
11 14 0
11 13 0
13 12 0
17 16 0
13 6 0
11 11 0

15 1 0
18 0 0
13 8 0
19 13 0
19 2 0
18 7 0
11 9 0
16 1 0
14 11 0
16 14 0
13 18 0
19 14 0
