width 20
height 20
....................
..........@.........
..@.........@..@.@..
..............@.....
.@...@..............
...........@........
.@......@..@........
......@..@.....@....
....................
........@....@......
.....@............@.
...@...@............
....@.@....@.....@..
..@.....@...........
......@.............
..@..........@......
....................
@.......@...@@....@.
.........@..........
.@@...@.............
8
12 14 0
15 15 0
13 0 0
2 5 1
3 10 1
9 6 1
12 3 2
5 1 2

13 16 0
15 15 0
10 19 0
2 4 1
19 17 1
10 6 1
0 6 2
16 16 2
