width 20
height 20
...@@...............
.....@..............
....................
.....@.....@........
..................@.
.@.@....@...........
....................
....................
....@.@.@......@....
....................
...................@
......@...@...@...@@
....@..............@
...........@........
.............@......
....@...............
.........@..........
@@....@....@........
..................@.
@..@@...............
8
9 6 0
3 1 0
4 7 0
15 19 1
0 5 1
19 15 1
19 16 2
17 6 2

19 17 0
14 17 0
15 3 0
15 18 1
6 4 1
11 19 1
4 5 2
18 15 2
