width 20
height 20
....................
.....@......@.......
....@...@........@.@
...............@@@..
................@...
......@....@.@......
...@................
.........@..........
......@.........@...
..........@.........
......@.@........@..
...@.....@..........
............@.......
@..........@..@....@
@...............@...
@...................
@.@..@..@@..@.......
.........@..........
....@...............
....@...............
8
3 3 0
13 19 0
10 12 0
8 5 1
14 4 1
7 1 1
18 17 2
2 5 2

12 19 0
0 5 0
10 13 0
15 4 1
12 2 1
4 8 1
13 14 2
5 11 2
