width 20
height 20
....@...............
.....@.@............
@....@..............
....................
....................
......@@@.........@.
@..............@....
........@........@..
.@...@........@.....
....@....@..........
...................@
........@...@.@.....
...@.@.........@@...
.@................@.
........@...........
............@.......
.....@..@.......@...
@.....@.............
....................
@.......@...........
8
3 5 0
19 4 0
5 3 0
7 0 1
10 0 1
10 12 1
19 3 2
16 3 2

13 16 0
9 1 0
19 1 0
9 2 1
8 2 1
3 5 1
14 7 2
0 14 2
