width 20
height 20
@@@@@@@@@@@@@@@@@@@@
@@@@@@@@@@@@@@@@@@@@
@@@@@@@@@.@@@@@@@@@@
@@@@@@@.@..@.@@@.@@@
@@@.@@@...@...@...@.
@@@..@@.@@.@.@..@@@.
....@..........@@@..
@.@..@.@@@.@@@..@@@.
@.@@.@.@...@...@.@@.
@@......@@..@@.@....
@@@.@@.@@@.@@@..@@.@
@@@.@@.@@@..@@@.....
@@.@@.@....@.@..@.@.
@.....@.@.@....@@@@@
@@@.@...@@@@.@.@@@@@
@@@@@@@...@@@@..@@@@
@@@.....@.@@.@@@@@@@
@@@@.@.@@......@@@@@
@@@@@..@..@@.@@@@@@@
@@@@@@@@.@...@@@@@@@
4
11 17 0
14 9 0
16 4 0
8 6 0

19 11 0
14 6 0
5 14 0
17 11 0
