width 20
height 20
.@..@.@.@........@@@
.@@.@.....@@@.@@.@@@
.@....@@@@.@.@@@....
..@@@..@.@.@..@..@.@
.@.@.@......@.@.@...
.......@@.@....@..@.
@.@.@.@@@.@@.@..@.@.
...@@@@@@@@@@..@@@@@
@.@@@@@@@.@@@@..@@@@
...@@@@@@...@.@.@@@@
@.@@@@@@@@@.@...@@@@
..@@@@@@@.....@.@@@@
@.@@@@@@@@.@.@.@.@@@
@..@@@@@@@@@......@@
@.@@@@@@@@@@@.@@.@.@
@@@@@@@@@@@@@@@@....
@@@@@@@@@@@@@@@..@.@
@@@@@@@@@@@@@@@@..@@
@@@@@@@@@@@@@@@@@@@@
@@@@@@@@@@@@@@@@@@@@
4
6 1 0
10 3 0
13 11 0
2 9 0

10 2 0
13 9 0
13 10 0
15 6 0
