width 20
height 20
....................
.@.@.........@......
...........@........
.................@..
...@....@.@...@....@
....................
...@..@....@.......@
...............@....
..........@.........
..@......@...@......
........@...........
....................
.....@...@......@.@.
............@.......
...@.@..........@...
........@...@@@.....
.........@..........
.......@............
................@@..
..@@.....@......@@@@
14
0 12 0
9 10 0
15 3 0
10 12 0
18 4 0
4 5 0
19 5 0
5 2 0
4 14 0
2 11 0
16 15 0
10 16 0
12 9 0
16 0 0

0 17 0
0 0 0
1 15 0
14 12 0
1 19 0
19 18 0
0 9 0
17 7 0
7 8 0
8 13 0
0 14 0
8 19 0
13 8 0
13 0 0
