width 20
height 20
@..@@...............
.@.@......@.........
....................
.........@...@......
........@.....@.....
....................
.@.@......@....@....
.....@.@............
....@.....@.........
....................
.....@.....@.@.....@
....@.........@...@.
...@................
.........@..........
................@...
.....@...@..........
.............@....@.
..............@.....
..@....@............
....................
14
8 1 0
17 12 0
11 14 0
15 13 0
0 13 0
17 10 0
16 6 0
1 4 0
17 6 0
15 0 0
6 8 0
4 2 0
9 19 0
3 18 0

18 17 0
1 0 0
19 16 0
5 0 0
0 17 0
11 15 0
12 2 0
7 2 0
14 13 0
1 9 0
2 12 0
13 18 0
19 3 0
8 16 0
