width 20
height 20
......@....@........
...........@........
......@..@@........@
...@.....@@..@......
........@@@.........
.......@............
.................@..
..............@.@...
.............@......
...@...........@.@.@
.........@.@........
.................@..
...@.......@....@...
..................@.
.......@.......@....
.....@..............
.@.........@.@......
....................
.......@...........@
....................
14
2 15 0
13 1 0
14 1 0
4 17 0
9 5 0
1 6 0
0 8 0
5 7 0
6 17 0
9 17 0
15 3 0
18 12 0
7 7 0
7 12 0

19 0 0
8 18 0
14 12 0
2 11 0
9 8 0
19 15 0
1 10 0
8 0 0
14 9 0
9 17 0
0 19 0
12 19 0
19 19 0
1 0 0
