width 20
height 20
................@...
..........@.........
...........@........
@.....@......@..@...
...................@
.@..............@...
...@...@.@...@......
..........@.........
.....@...........@..
............@.......
...@.@...@....@...@.
....................
..........@.@.@.....
.......@.......@....
..@........@........
..................@.
..@....@.@..........
........@....@......
..................@.
..@.................
14
2 11 0
9 5 0
0 0 0
3 2 0
6 11 0
11 19 0
2 3 0
17 0 0
12 2 0
7 19 0
8 8 0
14 5 0
16 15 0
1 19 0

2 4 0
11 12 0
2 1 0
7 4 0
6 16 0
7 1 0
2 3 0
13 14 0
9 19 0
4 15 0
19 0 0
0 19 0
17 19 0
9 13 0
