width 20
height 20
....................
...@.......@........
..@.....@...........
.@...........@......
.................@..
@.............@.....
........@.@.........
......@....@.......@
....@.....@..@.@....
.....@...........@..
.......@........@...
......@.....@..@....
.....@........@.....
..@......@.@........
..............@..@..
....@.............@.
@......@.@....@.....
..@.@.@....@........
..@.................
..@.................
14
13 10 0
8 17 0
5 11 0
12 2 0
6 0 0
18 14 0
0 14 0
8 10 0
15 0 0
2 14 0
0 10 0
5 13 0
7 13 0
18 12 0

11 14 0
0 14 0
1 18 0
2 16 0
12 18 0
18 5 0
7 17 0
3 13 0
5 18 0
16 17 0
14 2 0
17 3 0
16 7 0
7 11 0
