width 20
height 20
@.@..@@@@@@..@@@@@@@
....@@@@@@@.@@@@@@@@
@.@..@@@@@...@@@@@@@
@.@.@.@@@@@.@.@..@@@
@@@...@@.@.....@.@@@
@.@.@....@.@.@......
@..@.@.@..@@@..@.@.@
.@...@@.@.....@.@.@.
.@.@..@...@.@.......
..@..@..@..@@.@.@.@.
.@.@.@.@.@.@@@.@...@
..........@.@..@.@@@
@.@.@.@.@.....@.@...
...@.@.@@.@.@....@@.
@.@@.@..@@@@@@.@....
.......@@@@@@@@..@@@
@.@@.@@.@@.@@@..@.@.
.@.........@@..@....
...@.@.@.@..@@...@@.
.@..@@.@@..@@@@.@@..
9
8 5 0
11 1 0
6 5 0
7 9 1
1 6 1
7 14 1
5 4 2
16 15 2
16 4 2

16 14 0
6 14 0
9 9 0
16 13 1
2 6 1
17 14 1
18 17 2
8 5 2
18 12 2
