width 20
height 20
..@@@......@.@.....@
.@.@..@.@.@....@.@..
.@..@..@@..@.@@.@.@@
...@@@.@.@.@........
@@.@.....@...@@.@.@.
.....@.@@.@.@..@@@..
@.@@.@.@...@.@..@.@.
....@....@....@.....
@.@@@.@.@..@@@@.@.@@
....@@...@...@..@@@@
@.@@..@.@@@.@@@@@@@@
@@@.@.@.@@...@@@@@@@
@@..@.@...@.@@@@@@@@
@.@.....@..@@@@@@@@@
...@@.@@..@@@@@@@@@@
.@....@@@@@@@@@@@@@@
..@.@..@@@@@@@@@@@@@
.@@@@@@@@@@@@@@@@@@@
.@@@@@@@@@@@@@@@@@@@
.@@@@@@@@@@@@@@@@@@@
9
3 9 0
12 9 0
6 5 0
9 12 1
4 15 1
1 8 1
0 17 2
15 4 2
1 8 2

14 6 0
18 7 0
14 3 0
6 13 1
14 5 1
15 7 1
8 7 2
1 13 2
7 4 2
