width 20
height 20
@..@@@......@@@@....
..@.@.@.@.@.@@@.@@@.
@.@.....@@...@......
....@.@.@.@.@.@.@.@@
.@.@...@@........@.@
..@@@.@@..@.@.@@....
.@.@.@@.@..@@@.@.@.@
.@......@.@@@...@..@
...@.@@@@.@@.@.@.@..
.@.@...@.......@.@.@
@..@.@.@@@.@.@.@...@
..@@@@@.@@@@@@@@@.@@
@.@@.@..@@...@.@@@@@
......@.@.@.@....@@@
@.@.@.........@.@@@@
@@@@..@@@.@.@..@@@@@
@.@.@..@@@...@.@@@@@
......@.@@@.@@@@@@@@
@@@.@...@@..@@@@@@@@
@....@.@@@.@@@@@@@@@
9
12 14 0
0 3 0
18 9 0
1 12 1
0 13 1
11 13 1
0 3 2
4 15 2
7 1 2

11 13 0
16 9 0
18 2 0
13 15 1
3 7 1
11 4 1
7 7 2
5 15 2
2 9 2
