width 20
height 20
................@@..
.....@..........@..@
..@...@..@...@......
....................
............@.......
................@...
@..@..@....@........
@...........@@......
...........@......@.
....................
.@.@..........@.....
.......@..@..@......
.................@..
......@..@..........
................@...
....................
......@.@.....@..@..
.......@.@......@...
....................
@...................
12
8 17 0
15 10 0
7 12 0
17 18 0
18 6 0
8 15 0
1 3 0
9 4 0
3 5 0
15 17 0
16 6 0
19 11 0

3 1 0
4 7 0
4 9 0
3 0 0
1 18 0
18 2 0
18 15 0
11 3 0
1 7 0
14 17 0
2 0 0
4 1 0
