width 20
height 20
..........@........@
.............@......
...@................
.......@............
...........@........
...@................
..............@...@.
......@.@......@....
.......@....@.......
@...........@.....@.
@....@...@..........
@..@................
....................
.......@......@.....
.....@...........@..
....................
.@.........@..@@....
..@.@..@............
....................
....................
12
16 14 0
13 19 0
10 14 0
7 18 0
13 14 0
17 1 0
6 4 0
19 8 0
16 16 0
10 3 0
14 0 0
14 10 0

4 1 0
0 0 0
1 0 0
19 4 0
16 2 0
17 2 0
18 19 0
19 12 0
9 2 0
1 18 0
12 1 0
15 12 0
