width 20
height 20
..@@................
......@.......@.....
...............@....
....@...@...........
....................
....................
@.....@.@....@......
.....@...........@..
..........@.........
........@..@.....@..
.............@..@...
....@.............@.
@.............@.....
..@............@....
......@...@.....@...
..@...............@.
....................
...........@........
....@.....@@........
...@..........@@....
12
12 1 0
15 7 0
15 1 0
5 6 0
1 18 0
18 13 0
4 16 0
0 14 0
7 15 0
10 7 0
7 17 0
8 13 0

7 14 0
5 18 0
11 8 0
6 7 0
17 6 0
7 3 0
16 7 0
15 10 0
13 16 0
12 6 0
16 19 0
6 0 0
