width 20
height 20
....@..@............
....@...............
.@..........@.......
......@........@....
....................
............@...@...
......@.@...........
.........@..@.@.....
........@...........
@..........@........
.....@.@............
..........@.@..@....
......@@............
.....@@@........@...
..........@.@.......
........@...........
............@..@..@.
.@......@.....@.....
..................@@
@@.......@.........@
12
11 3 0
3 18 0
10 7 0
15 12 0
13 13 0
17 4 0
4 6 0
14 5 0
15 9 0
2 19 0
1 0 0
18 12 0

19 16 0
2 1 0
17 17 0
7 19 0
5 1 0
3 17 0
16 15 0
0 17 0
4 11 0
8 19 0
18 19 0
19 8 0
