width 20
height 20
....................
....................
....@...............
..@..@....@.@.......
......@........@....
....................
.........@..........
...........@........
...@....@.....@.....
...@@........@...@..
............@.......
...............@....
.@....@.............
..........@..@.@....
....@..@.@..........
...........@........
....................
....................
@...................
......@@@...........
12
5 13 0
1 13 0
10 10 0
11 1 0
17 16 0
13 3 0
19 5 0
16 11 0
4 4 0
13 15 0
10 16 0
19 11 0

13 8 0
10 14 0
17 1 0
16 9 0
9 10 0
17 8 0
2 6 0
0 2 0
3 19 0
5 15 0
12 16 0
19 11 0
