width 20
height 20
..@......@@.....@.@@
..@.......@.......@@
......@...........@@
.....@...@....@...@@
..................@.
..@.@.@.......@@....
..@.....@...........
...............@....
..@...@.............
.@........@..@..@...
.....@..............
...........@........
@@......@.......@...
@....@....@.........
...@................
.@............@.....
...@..........@@@.@.
.....@..............
................@...
@.........@@@.......
12
18 13 0
0 10 0
13 14 0
3 7 0
13 7 0
17 18 0
0 18 0
2 2 0
4 7 0
14 2 0
16 14 0
7 10 0

3 7 0
1 11 0
1 0 0
18 17 0
1 17 0
3 6 0
0 18 0
10 3 0
5 16 0
7 17 0
16 13 0
7 10 0
