width 20
height 20
@@@@.@@@.@...@.@@@@@
.@@..@@....@.....@@@
....@.@@.@.@@.@@..@@
@.@......@@@..@.@@@@
@@..@@.@..@.@...@@@@
@.@..@@@@.@..@@.@@@.
..@@.....@..@@@..@..
@.@@.@@.@@@....@.@@.
@...@....@@@.@@.....
@.@.@.@.@@@.....@@.@
...@.@.....@.@@@@@..
@@...@.@@.@..@@@@..@
.@.@@.@...@.@.@@@@..
........@@@.@..@@..@
@.@.@.@..@@.@.@@@@..
@@..@..@.@....@@@@@@
@@@..@..@@@.@..@@@@@
@@..@..@@@@@..@@@@@@
@@@.@@..@@@@@@@@@@@@
@@@@@@.@@@@@@@@@@@@@
10
6 17 0
13 1 0
14 13 0
2 12 0
15 8 1
9 10 1
19 10 1
2 10 2
8 1 2
6 10 2

12 5 0
6 16 0
9 5 0
14 4 0
11 15 1
11 9 1
19 5 1
2 10 2
5 13 2
5 17 2
