width 20
height 20
@@@@@@@@@.@@@@@@@..@
@@@@@@@@...@@@@.@.@@
@@@@@.@..@@.@.@...@@
@@.....@......@@.@@@
@@@.@@.@@@@.@@...@@@
@@@@@...@@.....@.@@@
@@@@@@.@@@@.@@..@@@@
@@@.@@.@.@..@@.@.@.@
.@.........@..@.....
.@@.@@@@.@...@.@@@.@
........@@@@........
@.@.@.@..@...@.@@.@@
@..@...@@@@.@@.@@@@@
..@@.@.@@@@@@@@@@@@@
.@@@@@@@@@@@@@@@@@@@
@@@@@@@@@@@@@@@@@@@@
@@@@@@@@@@@@@@@@@@@@
@@@@@@@@@@@@@@@@@@@@
@@@@@@@@@@@@@@@@@@@@
@@@@@@@@@@@@@@@@@@@@
10
10 9 0
7 8 0
11 6 0
9 0 0
0 8 1
15 1 1
14 12 1
12 3 2
9 1 2
12 11 2

10 9 0
7 8 0
3 3 0
11 3 0
0 8 1
5 2 1
14 11 1
6 8 2
11 11 2
13 3 2
