width 20
height 20
@@@@@@@@@@@@@@.@.@.@
@@@@@@@@@@@@@@......
@@@@@@@@@@@@@@@@.@@@
@@@@@@@@@@@@@@.@.@.@
@@@@@@@@@@@@........
@@@@@@@@@@.@@.@.@@.@
@@@@@@@@@....@.@.@..
@@@@@@@@@@@.@....@.@
@@@@@@@@@@...@.@....
@@@@@@@@@.@.@@.@.@.@
@@@@@@@.....@..@@@@.
@@@@@@..@.@.@@......
@@@@@@@..@@@@@.@.@@.
@@@@@@@.@.@.@.@....@
@@@@@@..........@@@@
@@@@@.@.@.@.@.@.@@@@
@@@@@....@.@@@@@.@@.
@@@@@.@.@...@.@.....
@@@@@@..@.@.....@.@@
@@@@@@@...@.@.@@@@@@
10
16 0 0
11 9 0
7 11 0
12 6 0
6 14 1
9 11 1
9 14 1
10 8 2
19 1 2
10 6 2

15 1 0
15 14 0
7 14 0
11 15 0
16 4 1
6 11 1
18 7 1
7 13 2
16 2 2
5 16 2
