width 20
height 20
@@@@@...@@@.........
@@@@.@@..@..@.@@.@@.
@.......@..@@@@@@@.@
..@.@.@...@.@.@@@@..
@@@@@@..@@.........@
..@.@.@..@@.@.@.@.@@
@.......@@@..@@..@.@
@.@.@.@@@@@.@@..@..@
...@.@@.@@..@.@...@@
.@.........@....@.@@
..@@.@.@.@.@@.@@.@.@
@.@@@@@...@...@.....
.@.@@.@@@@@@.@.@.@@.
....@...@.@......@@.
.@.@@.@.....@.@.@@..
@..@.@@.@@.@@@..@.@.
@@.......@@@@..@..@.
.@@.@.@.@@@@@@..@...
.....@...@@@@@.@@@@.
@@.@..@.@@@@@@@@@...
6
6 10 0
8 11 0
4 6 1
19 11 1
11 4 2
12 9 2

13 0 0
7 11 0
11 5 1
0 8 1
16 0 2
5 13 2
