width 20
height 20
@@@@@@@@@@@@@@@@@@@@
@@@@@@@@@@@@@@@@@@@@
@@@@@@@@@@@@@@@@@@@@
@@@@@@@@@@@@@@@@@@@@
@@@@@@@@@@@@@@@@@@@@
@@@@@@@@@@@@@@@@@@@@
@@@@@@@@@@@@@@@@@@@@
@@@@@@@@@@.@@@@@@@@@
@@@@@@@@@@.@@@@@@@@@
@@@@@@@@@..@@@.@@.@@
@@@@@@@@@@........@@
@@@@@@@@@.@@@@.@.@.@
@@@@@@@@@.@@...@.@..
@@@@@.@@@..@@.@.@.@.
@@@@@..@..@.........
@@@@..@.@.@.@@@@.@.@
@@@@@.......@....@..
@@@@@@@.@.@.@@.@..@.
@@@@@@@@...@...@@@@@
@@@@@@@@@.@@.@......
6
5 15 0
14 17 0
18 15 1
18 14 1
16 15 2
10 7 2

5 14 0
17 17 0
14 14 1
10 7 1
11 17 2
9 9 2
