width 20
height 20
@@@@@@@@..@@.@@.@@@@
@@@@@@@..@.......@@@
@@@@@@@.@.@@.@@.@@@@
@@@@@@@........@@@@@
@@@@@@@.@.@.@@@.@.@@
@@@@@@...@@@@......@
@@@@@..@@.@.@@.@@.@@
@@@@@@..@.@.@...@...
.@@@@..@@....@.@@@.@
..@@..@...@@@...@...
.@.@@.@.@.@..@@..@.@
...@.....@@@.@.@..@@
.@@.@@@.@.@......@.@
............@.@.@...
@.@.@.@.@.@.@..@@@.@
@@@..@...@@@@.@@...@
@@@.@@@.@.@@@.@.@@.@
@@@..@@@............
@@@@..@@@@@.@.@.@.@.
@@@..@@@@@@@@@...@..
6
15 19 0
7 1 0
4 19 1
3 13 1
11 17 2
17 4 2

15 10 0
11 1 0
11 4 1
17 6 1
13 9 2
15 17 2
