width 20
height 20
...............@@...
........@...........
.......@............
............@@@...@.
.....@...@..........
....................
....@.@.............
.....@.@............
............@....@.@
.......@.......@....
...@......@.@.......
..@..@.............@
....................
....................
@........@..........
....@...@...@.......
.@..................
.........@..........
....................
@...........@@......
7
1 4 0
13 9 0
5 2 0
15 10 0
6 15 0
9 0 0
4 13 0

0 4 0
1 3 0
19 19 0
0 10 0
16 2 0
16 19 0
5 14 0
