width 20
height 20
@@@@@@............@@
@@@........@......@.
@@@.................
@.....@.........@...
........@...........
..........@.........
...@.......@..@.....
....@............@..
@......@@@.........@
......@......@@@...@
.............@@@....
@@..@.@..@...@@..@..
@@@.................
@@@.................
@...@...............
.............@......
...........@...@...@
.@...@....@......@.@
..............@.....
....................
7
4 3 0
6 7 0
19 12 0
15 8 0
17 18 0
0 6 0
16 10 0

5 11 0
6 7 0
2 3 0
3 2 0
14 3 0
19 13 0
0 4 0
