width 20
height 20
....................
....................
@..............@.@..
.......@..@.@.......
........@....@......
@.@..@............@.
....@..........@@...
.........@....@.....
...@.@..............
.......@.....@.@....
..@...@..@......@...
@...........@.......
@.........@.....@.@.
@...@.@......@......
@@.@...@..@.@.......
@@............@.@...
@@.......@..........
@@..................
........@..........@
.........@.........@
7
11 3 0
6 17 0
12 4 0
9 2 0
14 2 0
3 6 0
19 13 0

7 2 0
9 11 0
13 7 0
8 16 0
6 4 0
13 15 0
19 13 0
