width 20
height 20
@..............@@@@@
...@........@..@@@@@
..........@.......@@
@@....@.............
@.......@...........
...............@....
.@..........@.......
......@.........@...
..............@.....
..@......@.@........
.@.............@....
............@.......
@.....@.........@...
...@......@.@.......
..@.................
@@.....@.@..........
........@.@.@.......
...............@@...
................@...
....................
7
1 18 0
0 13 0
2 11 0
8 3 0
13 3 0
19 19 0
12 5 0

9 18 0
2 12 0
14 7 0
11 18 0
18 16 0
18 17 0
13 11 0
