width 20
height 20
..........@.........
.............@.@....
....................
......@..@..........
........@........@..
.@..................
..........@@@@..@...
.........@.@@.......
...@..........@.....
..@....@............
....................
....................
....................
@....@...........@..
.........@......@...
...@...@@@..........
......@.......@.....
.....@..@........@@@
.................@@@
............@@...@@@
7
16 16 0
2 0 0
16 15 0
3 17 0
4 3 0
10 14 0
10 15 0

2 15 0
0 8 0
0 0 0
7 8 0
19 11 0
2 17 0
10 15 0
