width 20
height 20
...@...@@.@@@@.....@
...@................
........@...........
..@.............@.@.
.....@.....@@.......
......@.............
.......@........@...
..@......@.@........
....................
.....@......@.@.....
...@.....@..........
@...................
....................
..@....@............
........@.....@.....
...@.........@..@...
.@.......@..........
....................
.....@.............@
@..................@
7
10 9 0
1 4 0
12 14 0
16 17 0
8 8 0
3 11 0
19 9 0

1 2 0
6 2 0
11 19 0
11 5 0
6 19 0
18 9 0
18 7 0
