width 20
height 20
@@@@.@.@...@.@@@@@@@
@@@@.....@.....@@@@@
@@@@@.@@.@@.@@@@@@@@
@@@@@@@....@.@@@@.@@
@@@@@@..@.@...@@@..@
@@@@@.@..@.@.@.@.@..
@@@....@...........@
@@..@.@@.@.@@@.@.@.@
@..@.....@....@..@..
@@.@.@.@..@.@..@@..@
...@..@.@@...@@@@@.@
.@@@.@....@.@@@@@..@
@@@..@@@@....@@@.@..
@@@@...@@@@.@.@@.@.@
@@@@.@.@.@@@.....@..
@@@..@....@@@@.@...@
@@@@.@@@.@@@@...@.@@
@@@@@@@..@@@.@@.@...
@@@@@@@@..@@....@.@.
@@@@@@@@@..@@@@.@@..
12
6 8 0
9 4 0
13 6 0
5 2 0
18 4 1
10 19 1
16 12 1
17 16 1
8 15 2
7 5 2
11 8 2
11 12 2

15 17 0
18 4 0
19 8 0
9 18 0
11 4 1
18 14 1
4 14 1
14 6 1
17 11 2
13 14 2
5 8 2
10 7 2
