width 20
height 20
.@@@..@@@@@@@@@@@@@@
.....@@@@@@@@@@@@@@@
.@@@..@@@@@@@@@@@@@@
.@@..@@@@@@@@@@@@@@@
@...@.@@@@@@@@@@.@@@
@@@...@@@@@.@....@@@
@@@@.@@@@@..@.@.@.@@
@@@.....@.@...@....@
@@@@.@@....@@..@.@.@
@@@@@.@.@.@@..@@@@@.
@@@@@..@....@..@@@..
@@@@..@@@.@...@.@.@.
@@@..@.@@@..@.@.....
@@@@.@.@@@@.@.@@.@@@
@@.@....@@@@@.....@@
@@..@.@@.@@...@@.@@@
@@.@........@...@@@@
.....@.@@.@..@@@@@@@
@.@@.@@@@@@.@@@@@@@@
@...@@@@@@@@@@@@@@@@
12
11 13 0
16 13 0
13 9 0
12 7 0
5 5 1
0 0 1
4 12 1
5 11 1
12 15 2
18 12 2
10 16 2
4 16 2

15 14 0
14 8 0
19 11 0
0 0 0
17 7 1
10 12 1
4 1 1
3 4 1
0 1 2
16 15 2
13 15 2
16 7 2
