width 20
height 20
@.........@.......@@
.@.@.@.@@...@@.@.@@@
...@@@@@..@..@.@.@@@
@@.@.....@@.@@@@@@@@
@@.@.@@@..@@@@@@@@@@
@@.@@.@@.@@@.@@@@@@@
.......@@.@..@.@@@@@
@.@.@.@@@...@....@@@
...@....@.@..@.@@@@@
@.@@@.@@.@.@.....@@@
@@@@@........@@.@.@@
@@@@..@.@.@.@@@...@.
@@@..@...@..@@..@.@.
@@@@.@@.@.@@...@....
@@@@@.....@..@@@@.@.
@@@@..@.@.@@@@@@@@@.
@@@@@..@@.@@@@@@@@..
@@@@@@.@...@@.@@@@@.
@@@@...@.@@.....@@@.
@@@@@.@.....@.@@@@@.
12
17 10 0
16 7 0
2 5 0
2 1 0
11 12 1
6 8 1
5 14 1
10 7 1
17 0 2
18 16 2
11 7 2
9 8 2

17 0 0
14 6 0
5 10 0
7 10 0
17 13 1
16 2 1
5 14 1
9 6 1
6 8 2
14 12 2
8 0 2
1 7 2
