width 20
height 20
........@..........@
.....@.............@
.................@.@
...@............@..@
...@........@.......
.....@...@..........
..........@..@......
.........@......@...
.@...@..............
..........@.....@...
......@.@..@........
....................
....@.............@@
.............@....@@
....@...........@.@@
......@.@..........@
..........@.........
......@.............
....................
......@@............
11
14 5 0
0 11 0
19 11 0
15 12 0
5 6 0
13 5 0
5 0 0
2 14 0
0 18 0
16 18 0
8 2 0

1 19 0
17 9 0
17 11 0
4 13 0
16 2 0
13 5 0
15 3 0
1 1 0
12 7 0
16 18 0
2 4 0
