width 20
height 20
.....@@....@......@@
.....@@...........@@
...................@
..@.................
.............@......
.........@.@......@.
..@@.@..............
...@......@...@.@...
.@...........@......
...........@........
....................
...............@....
....@...............
....................
.........@..........
...@.......@..@.@...
@...................
.....@..............
.@..................
.......@..@@........
11
15 3 0
12 1 0
3 3 0
11 11 0
11 4 0
13 13 0
7 4 0
8 11 0
3 11 0
6 18 0
2 19 0

12 16 0
10 2 0
15 13 0
18 12 0
11 4 0
4 17 0
7 0 0
13 13 0
9 10 0
8 17 0
2 11 0
