width 20
height 20
...................@
...................@
....@...............
@...........@.@.....
...@..............@.
...@@@..............
....@@@.......@.....
............@@......
...@.........@@.....
.........@@.........
.........@@..@..@...
.......@@...........
............@.......
...........@.@......
.@..@....@.........@
...........@.......@
..@.@...@....@......
................@...
.........@..........
......@.....@@@..@@@
11
19 9 0
3 11 0
7 14 0
8 8 0
12 0 0
12 2 0
2 9 0
11 4 0
3 12 0
0 5 0
18 6 0

17 9 0
16 7 0
2 0 0
0 8 0
15 8 0
12 1 0
17 5 0
1 18 0
15 3 0
19 18 0
19 9 0
