width 20
height 20
....................
....................
.......@............
...@................
.................@..
.......@.@......@...
.....@.....@.@......
....................
.........@..@.......
...@.....@..........
.....@.........@....
..........@.......@.
........@.@.@.@.....
.............@......
......@..@..........
..........@..@..@...
@.@.@...............
.........@..........
....................
...............@@...
11
12 1 0
13 0 0
2 6 0
11 2 0
16 7 0
2 11 0
1 14 0
5 2 0
11 11 0
9 0 0
18 7 0

10 4 0
3 10 0
17 19 0
0 0 0
8 8 0
12 4 0
10 6 0
7 3 0
14 3 0
16 2 0
19 6 0
