width 20
height 20
...@@@..@.@@@..@@@@@
@.@@@..@...@.@..@@@@
...@..@@@@....@...@.
@.@@@..@@@@@@...@@..
..@@..@@@@.@..@@..@.
@....@@@@@..@.@.@...
..@.@@@@@@@.....@.@.
@..@@@@@@@..@.@.@.@.
..@@@@@@@@@..@....@.
@.@@@@@@@@@@..@@@@@@
..@@@@@@.@@@@...@.@.
@..@@@@..@@@..@@....
..@.@@.@....@...@@@.
@........@.@@.@@@...
.@.@@.@.@......@.@.@
.@..@@@@.@.@.@......
...@@@@@...@@..@.@@@
.@..@@@@@.@...@..@@@
.@.@.@@@@@..@..@..@@
.@....@@@@@..@.@@.@@
3
15 12 0
0 16 1
19 11 2

11 5 0
1 6 1
8 16 2
