width 20
height 20
@.@..@.@@@@@@@@@@@..
@.@@....@.@@@@@@.@.@
@...@.@@...@@@@..@..
@@@.....@.@.@.@@.@.@
@@@.@.@.............
@@@.@..@.@.@.@.@.@@@
@@@@@.@@@@@..@..@@@@
@@@@@...@@@@..@.@@@@
@@@@..@.@@@@@@@@@@@@
@@@@@@@@@@@@@@@@@@@@
@@@@@@@@@@@@@@@@@@@@
@@@@@@@@@@@@@@@@@@@@
@@@@@@@@@@@@@@@@@@@@
@@@@@@@@@@@@@@@@@@@@
@@@@@@@@@@@@@@@@@@@@
@@@@@@@@@@@@@@@@@@@@
@@@@@@@@@@@@@@@@@@@@
@@@@@@@@@@@@@@@@@@@@
@@@@@@@@@@@@@@@@@@@@
@@@@@@@@@@@@@@@@@@@@
6
14 4 0
12 7 0
4 0 1
3 5 1
4 3 2
5 5 2

5 2 0
5 3 0
3 5 1
19 4 1
5 1 2
19 0 2
