width 20
height 20
...............@....
.@.@@.@@@.@.@@@.@@@.
..@@@@@@@@@.....@@..
.@@@@@@@.@@@@.@.@.@.
.@.@.@.....@@@......
.......@@.@.@@@.@@.@
.@.@@.@.@...@@@@....
@@...@...@@..@@@.@.@
@.@.@.@@...@@@@@.@..
......@@.@@@@@@...@@
@.@.@.@@...@@@@@.@.@
..@..@...@.@@@@@....
@..@.@@.@.@@@@.@.@.@
..@@.......@.....@.@
@.@@@@.@@@@..@.@@..@
..@@@.@.@@@@@@@@@@.@
@........@@@@@@@@@.@
@.@.@.@.@@@@@@@@@..@
.@@.@@@@@@@@@@@@@.@@
....@@@@@@@@@@@@@..@
6
9 13 0
15 13 0
2 12 1
4 9 1
13 13 2
0 13 2

16 4 0
3 18 0
2 12 1
4 12 1
5 0 2
5 16 2
