width 20
height 20
@.@@@@@@@@@@@@@@@@@@
..@.@@@@@@@@@@@@@@@@
@....@.@@@@@@@@@@@@@
@@@.@......@@@@@@@@@
@@..@.@.@.@@@@@@@@@@
@@@....@@@@@@@@@@@@@
@@@.@@..@.@@@@@@@@@@
@@@@.@.@...@@@@@@@@@
@@@.....@.@@@@@@@@@@
@@.@.@@@...@@@@@@@@@
@........@.@@@@@@@@@
..@.@@.@..@@@@@.@@@@
.@@.@..@.@@@@@...@.@
@@@@.@.@..@@@..@....
@@@...@.@.@@@@..@@.@
...@@.......@..@@@@@
@@....@@.@.@@.@@@@@@
.@@.@@@..@.....@@@@@
.....@@@@..@.@..@@@@
@@@.@@@@..@@@..@@@@@
6
10 9 0
8 11 0
8 15 1
2 2 1
5 8 2
1 0 2

14 12 0
10 9 0
9 3 1
8 17 1
1 18 2
18 13 2
