width 20
height 20
@..@@@..@@@@.....@@.
..@.@@.@.@@@@@@.@@..
@......@....@@@...@.
@@.@.@...@.@....@...
.@..@..@@....@.@..@@
...@@@..@.@@@@@@@...
.@@@.@.@@..@@@@@..@.
.....@@@@@..@.@.@.@.
.@.@.@@@@@.@.......@
@...@@@@@@@..@.@@.@@
@.@.@@@@@@@@..@@@@@@
...@@@@@@@@@.@@@@@@@
@.@@.@@@@@.@@@@@@@@@
......@@@@.@@@@@@@@@
@.@@.@@@@..@@@@@@@@@
@@...@@@.@.@@@@@@@@@
@@@@..........@@@@@@
@@@@@.@.@.@@@..@@@@@
@@@@@@@.@....@@@@@@@
@@@@@@..@.@.@@@@@@@@
6
0 11 0
5 13 0
1 1 1
0 4 1
1 7 2
12 16 2

2 8 0
5 17 0
19 0 1
1 5 1
4 14 2
9 16 2
