width 20
height 20
@@@......@@@@@@@@@@@
@@........@@@@@@@@@@
.....@...@@@@@@@@@@@
...........@@@@@@@@@
....@..@...@@@@@@@@.
.....@......@@@.....
..@........@@@......
.....@..@......@....
.........@...@......
.@.@......@......@..
................@@..
.@..@...........@...
......@....@.@...@..
.......@............
.....@..............
........@....@......
...@................
....................
....................
..............@.....
4
8 5 0
5 18 0
9 1 1
0 16 2

17 18 0
16 6 0
9 1 1
8 1 2
