width 20
height 20
....................
...............@....
....................
.........@..........
.@...@..@......@....
....................
....................
......@...@..@......
.........@..........
....................
@@......@...........
@...@.....@.........
@......@.....@......
@....@..............
.....@.......@..@...
...................@
........@..@.....@..
....................
.................@@@
................@@@@
4
11 19 0
14 3 0
11 4 1
15 10 2

1 0 0
10 10 0
8 2 1
3 19 2
