width 20
height 20
........@@@.@..@..@@
@@@.@.@@@@@..@..@.@.
.@.@@.@.@.@.@.@.....
................@.@.
@.@.@.@@.@.@.@.@...@
...@..@.@.@.@.@.@.@.
@.@@@@@.@.@.........
@@@@@.......@.@.@.@@
@@@@@@.@.@.@@.@.@@..
.@@@....@@@....@.@.@
.@@@@@.@.@.@@.@.....
..@@@.......@...@@.@
.@.@.@.@@.@..@.@@@@@
........@@..@@@@@@@@
.@.@.@.@@@.@@@@@@@@@
.@@...@@@...@.@@@@@@
..@@.@.@.@@....@.@@@
.@@@.@.@....@.@...@@
@@@....@@.@.@...@..@
@@@@.@@....@..@@@.@@
5
9 2 0
5 11 0
13 0 0
2 0 0
6 17 0

9 15 0
11 1 0
9 18 0
4 16 0
5 3 0
