width 20
height 20
@@@@@@.@@@@.@..@@@@@
@@@@@..@@@....@.@@@@
@@@@@@..@@@.@...@@@@
@@@@@..@.@.@@.@.@@@@
@@@@.@...@.@.@@...@.
@@@....@.....@.@.@..
@@@.@.@..@@@......@.
@@.@.@.@@@@@.@.@.@@.
@....@.@.@..@@@@....
.@.@@....@.@@@...@.@
...@.@.@@@..@@.@..@.
.@.....@.@.@.@..@...
..@.@.@@.......@..@@
.@.@.@.@.@.@.@.@@.@.
..........@..@@.@@..
.@.@.@.@.@.@.....@.@
@@..@@@.@@.@.@@@....
@@@.@@@.@@.@@....@@@
@@.......@.@@.@@.@@@
@@.@.@.@.@......@@@@
5
15 6 0
2 11 0
1 12 0
3 11 0
8 3 0

2 8 0
12 15 0
19 10 0
19 7 0
15 15 0
