width 20
height 20
@.@@@@@@...@@@@@@@@@
...@@@@@@@..@@@@@@@@
@.@.@@.....@.@.@.@.@
@......@.@.........@
@@.@.@..@.@.@.@@.@.@
@@@@@..@.....@@@@@..
@@.@.@@@@.@.@@@@@@.@
@....@.@@@.@@@@@@@..
@@.@.......@@@@@@@@.
@@@@.@.@.@.@@@@@@@..
@@@@@@@@@..@@@@.@.@.
@@@@@@.@.@..@.......
.@@@@......@@.@@.@.@
.@@@.@.@.@.@@.@.@...
........@.@.@.@..@.@
@.@.@@.@@.......@@@@
..@@....@.@.@.@..@@@
@.@.@@.@.@.@.@.@.@@@
.....@.............@
@.@.@@.@.@.@@.@.@@..
5
12 15 0
17 3 0
12 17 0
7 12 0
5 5 0

6 11 0
5 16 0
14 3 0
9 5 0
6 12 0
