width 20
height 20
..........@@.......@
..........@@.......@
.@.....@@.......@..@
......@@@.....@@....
....................
....@......@.@.@....
.@.....@....@.......
...........@......@.
...............@....
....................
..@.....@.@..@....@.
...@................
......@.............
.......@.........@..
@....@..@.......@...
.........@..........
....@.......@....@..
....@...............
........@.@.......@.
....................
5
11 4 0
8 5 0
17 11 0
9 17 0
3 17 0

0 16 0
6 19 0
1 18 0
14 0 0
0 17 0
