width 20
height 20
..........@@.......@
....................
...@...@......@..@..
........@.........@.
.................@..
..@....@............
.@....@.......@..@..
.....@...@.@....@...
....................
................@...
.......@............
....................
....................
....................
..........@.........
.....@......@...@...
..@...@........@....
........@...........
....................
....................
5
0 16 0
6 7 0
18 12 0
8 2 0
11 13 0

14 5 0
16 13 0
16 10 0
7 17 0
17 17 0
