width 20
height 20
.............@......
..............@.....
..........@..@....@.
....................
......@..........@..
.......@......@.....
........@...........
...@................
..@.@........@......
.....@.@..@.....@...
....................
.............@.@....
....@@..@...@.......
..........@......@..
.....@........@.....
..................@.
.........@..........
....@..@...........@
.....@..............
....................
5
15 1 0
1 0 0
18 14 0
13 9 0
4 9 0

6 6 0
3 1 0
19 0 0
2 13 0
8 1 0
