width 20
height 20
....................
....................
.................@..
........@...........
....@.@....@.....@..
.......@............
....................
..@.@.@.............
.........@..........
..........@..@......
....@...............
.................@@@
......@.@.....@...@@
...@........@......@
..........@......@..
@...@...............
.....@...@.........@
....................
......@........@....
@@@@................
5
17 10 0
16 2 0
7 4 0
12 5 0
12 10 0

7 13 0
0 18 0
1 18 0
19 18 0
12 10 0
