width 20
height 20
...........@@@@@....
....................
.........@..@...@...
....................
....................
......@.......@@....
............@.@.....
...@.....@.@..@.@...
@...................
........@..@.@..@...
....................
...@...@..@.@..@..@.
....................
....................
.........@....@.....
@..............@...@
......@............@
..................@.
..........@.@.......
..@....@@...........
5
1 6 0
6 1 0
19 11 0
1 9 0
2 1 0

0 17 0
17 1 0
3 16 0
19 1 0
18 15 0
