width 20
height 20
@...................
......@@............
...............@....
..........@.........
.................@..
..@...........@....@
...........@........
......@@..@.........
................@...
..@....@...@........
..............@..@..
........@@.@@@......
.......@.@..@@......
.....@......@@....@.
............@@......
....................
........@.@.@.......
...@...........@..@.
....................
@...................
5
18 12 0
8 14 0
17 9 0
9 4 0
15 16 0

12 19 0
15 4 0
17 7 0
5 2 0
12 1 0
