width 20
height 20
@@@........@@.......
.@@........@........
....@......@........
..@.............@.@.
..........@..@.@....
....@....@..........
...@.@........@.....
...........@........
@...@.@.............
@...................
........@..@..@.....
.........@..........
.@..................
...@.@..............
............@.......
...@.......@..@.....
................@@..
......@.@...........
............@.@.....
..................@.
5
10 0 0
16 10 0
6 16 0
14 7 0
7 0 0

7 13 0
0 17 0
18 1 0
2 13 0
6 6 0
