width 20
height 20
....@...@...........
........@...........
...............@....
............@@......
.............@......
.@.@.@..........@...
....@..@............
.@..................
....................
.......@.@....@.....
..@...@...@.........
....@..@....@..@....
....................
..@.@..............@
.....@..............
.......@............
..........@.......@.
@@..................
@@...@.............@
.......@.....@...@@@
5
4 9 0
16 17 0
19 8 0
2 18 0
10 19 0

6 1 0
7 4 0
16 12 0
19 0 0
19 7 0
