width 20
height 20
....................
@@..................
@@....@..@...@......
@@..................
................@...
.......@.@..........
............@.......
......@.......@.@.@.
........@...........
...@......@.......@.
......@..........@..
....................
@.@..............@..
.........@.@.@......
..........@.........
....................
.@............@.@...
.@.......@.@.@......
...@................
.........@@....@..@.
14
17 14 0
2 1 0
0 5 0
16 8 0
14 11 0
19 15 1
10 5 1
19 8 1
16 3 1
12 19 1
3 1 2
19 11 2
16 13 2
10 18 2

3 2 0
2 1 0
19 18 0
16 17 0
12 2 0
16 0 1
9 14 1
19 6 1
13 10 1
19 3 1
3 5 2
15 11 2
0 0 2
12 13 2
