width 20
height 20
.@@@@@.............@
.@@@@@..@...........
....................
............@.@..@..
....................
..@......@..........
.....@......@...@.@.
....................
.........@..........
....@...............
@...........@...@...
..@........@........
....................
..@@@.........@.....
..@@...@.@..........
....@.@.....@.......
....................
@........@..@.......
@......@........@...
@...................
14
13 16 0
4 19 0
8 17 0
3 7 0
11 15 0
16 16 1
7 19 1
1 5 1
18 14 1
13 14 1
9 1 2
9 11 2
0 7 2
17 1 2

1 2 0
4 19 0
0 6 0
3 7 0
12 19 0
7 3 1
8 0 1
19 17 1
2 2 1
13 0 1
19 5 2
3 9 2
10 17 2
3 12 2
