width 20
height 20
....................
.@......@...........
.....@........@...@.
....@...............
........@...@@@.....
.....@..............
..@.@......@...@....
..........@.........
....................
@....@..@.@......@..
...@...........@....
.......@............
....................
..............@..@..
.......@..@....@....
..@.@.........@.....
...@........@....@..
.........@..........
...@@...............
...@@@@@.@..........
14
19 13 0
7 17 0
3 11 0
19 5 0
10 6 0
0 4 1
18 13 1
8 7 1
3 13 1
4 0 1
15 5 2
8 5 2
12 9 2
1 18 2

15 13 0
19 1 0
5 11 0
14 0 0
11 1 0
18 18 1
0 17 1
18 1 1
19 18 1
13 18 1
9 5 2
14 3 2
19 19 2
14 11 2
