width 20
height 20
........@.........@.
..........@.........
.....@..............
.........@..........
............@.......
.......@..@..@......
.@..................
....@...............
.......@............
@...@......@....@.@.
@@..@@.........@....
@@..@....@.....@..@.
....@...............
....@......@........
..............@.@...
.......@....@.......
..................@.
...@.........@....@@
..@.@.......@.....@@
...................@
14
17 13 0
13 0 0
8 3 0
0 8 0
16 4 0
2 12 1
5 14 1
16 8 1
6 12 1
19 4 1
15 4 2
9 13 2
10 9 2
18 8 2

4 14 0
12 3 0
19 3 0
18 14 0
16 4 0
18 7 1
18 6 1
14 9 1
14 0 1
17 19 1
14 11 2
6 17 2
6 7 2
11 3 2
