width 20
height 20
......@.....@@......
....................
.@.....@@.@.........
............@....@..
..@...........@.@.@@
...@................
.....@.@............
.............@......
.......@............
...@.....@..........
..@.@......@..@.....
....................
...........@..@.....
.................@..
...@.@..............
............@...@...
....................
.......@@......@...@
@......@@..........@
@......@@@.@.......@
14
10 15 0
6 13 0
14 1 0
5 19 0
19 7 0
3 12 1
16 3 1
17 4 1
15 3 1
4 11 1
7 11 2
8 7 2
16 10 2
10 5 2

18 1 0
3 7 0
2 18 0
16 6 0
11 1 0
19 0 1
6 8 1
18 6 1
10 5 1
10 0 1
17 0 2
16 19 2
7 5 2
8 9 2
