width 20
height 20
...@................
.................@..
.....@..............
.@....@...@...@.....
..@......@.@.@.@....
@..................@
@...................
..@..@.@.@..........
...............@....
@.@..@..........@...
...@....@.......@...
............@..@@...
......@.............
..@............@....
.....@.....@.....@..
....................
.@.@................
.@............@.....
....................
...................@
3
3 8 0
17 0 0
2 15 0

7 14 0
13 6 0
2 8 0
