width 20
height 20
....................
..@...............@.
.............@......
.......@.@..........
.....@.....@........
..@............@....
......@.@.........@.
@@...@......@.......
....@........@......
.....@....@.........
.......@.@...@......
...@........@......@
..................@.
@..........@........
.......@............
............@.......
.....@........@.....
....@.............@.
........@@......@@@@
........@@@@.....@@@
3
8 7 0
13 3 0
10 2 0

3 1 0
17 4 0
6 14 0
