width 20
height 20
@@@@@@@@@@@@@@@@@@@@
@@@@@@@@@@@@@@@@@@@@
@@@@@@@@@@@@@@@@@@@@
@@@@@@@@@..@@@@@.@@.
@@@@@@@@..@.@.......
@@@@@@@@@.....@@.@.@
@@@@@@@@..@.@.@.@...
@@@@.@..@..@@@....@.
@@@....@.@.@@.@.@@..
....@.@...@.....@@@.
@.@.@.@.@@..@.@..@@@
@@...@@...@.@.@.@.@.
.@.@@...@....@......
......@.@.@.@@.@@.@.
@.@.@..@@@@@@@...@.@
@.@@..@@@@@@@@.@....
...@@..@@@@@@@@..@@.
@@..@.@@@@@@@@@.@@@.
...@@..@@@@@@@@.@@..
.@@...@@@@@@@@@@@@@.
7
18 6 0
18 8 0
5 9 0
6 18 0
15 9 0
19 13 0
19 18 0

6 12 0
13 4 0
15 8 0
11 6 0
3 17 0
11 9 0
9 7 0
