width 20
height 20
@@@@@@@@@@@@@@.@....
@@@@@@@@@@@@@....@.@
@.@@@@@@@@@@@@@@.@..
@.@@@@@@@@@@@@@@..@.
@.@@@@@@@@@@@@@..@@@
.......@@@@@@@@.@.@.
@.@@@.@@@@@@@@......
..@@...@@@@@@..@.@@.
@.@@@.@@@@@@@@..@@..
@.@.@@@@@@@@@@@@.@.@
......@@@@@@@@@@.@.@
.@@.@@.@.@.@.@......
@.............@@.@.@
.@.@@@.@@.@.@.@@@...
...@@@@...@@@..@.@.@
@.@@@@@@@..@..@@.@.@
@@@@@@@@@@.@@.@....@
@@@@@@@@@@@.....@.@@
@@@@@@@@@@..@@@..@@@
@@@@@@@@@@@....@..@@
7
1 3 0
13 19 0
16 4 0
19 8 0
9 13 0
6 7 0
18 11 0

1 15 0
12 17 0
3 10 0
5 6 0
18 11 0
4 12 0
14 0 0
