width 20
height 20
.@@@@@@@@@@@@@@@@..@
.@.@@@@@@@@@@@@@..@@
....@@@@@@@@@@@.@...
@@.@.@@.@@@@@@@...@@
.....@..@.@@@@..@...
.@@.@.@........@.@.@
...@..@@@.@.@@...@..
.@..@....@@.@..@..@@
.@.@@.@@@@..@.@.@..@
.@.@.....@@..@....@@
.@@@@@.@..@.@@@.@@@.
.@.@.@@..@.@.@......
.......@......@@@.@@
@.@@.@...@.@.@....@@
....@@@.@@@....@@..@
@.@.@@@@@@@@.@.@..@@
...@@@@@@@@@..@@@@@@
@.@@@@@@@@@@@.@@@@@@
..@@@@@@@@@@@@@@@@@@
@@@@@@@@@@@@@@@@@@@@
7
1 12 0
4 3 0
17 2 0
12 9 0
3 7 0
13 7 0
10 12 0

8 7 0
0 0 0
17 11 0
11 14 0
1 18 0
0 7 0
17 4 0
