width 20
height 20
@@@@@@@@@...@....@.@
@@@@@@@@.@.@.@@.@...
@@@@@@@@..........@.
@@@@@@@@@.@@.@@.@@..
@@@@@..@....@.@.@@@.
@@@@@.@@@.@....@@@@@
@.....@.@.@.@.@@@@@@
@@@.@.....@@@@@@@@@@
@.@@@@.@.@@@@@@@@@@@
...@.@@...@@@@@@@@@@
@.@...@@.@@@@@@@@@@@
@.@@.@...@.@@@@@@@@@
.......@.@..@@@@@@@@
@@.@.@.@@..@@@@@@@@@
@@..@....@..@@@@@@@@
...@@@@@.@.@@@@@@@@@
@.@.@@@@...@@@@@@@@@
......@@.@..@@@@@@@@
@.@@@...@@@@@@@@@@@@
@...@.@@@@@@@@@@@@@@
7
7 11 0
11 2 0
2 15 0
14 2 0
15 4 0
6 4 0
15 1 0

8 8 0
4 13 0
1 11 0
10 16 0
3 12 0
9 7 0
15 3 0
