width 20
height 20
@@@@@@@@@@@@@@@@@@@@
@@@@@@@@@@@@@@@@@@@@
@@@@@@@@@@@@@@@@@@@@
@@@@@@@@@@@@@@@@@@@@
@@@@@@@@@@@@@@@@@@@@
@@@@@@@@@@@@@@@@@@@@
@@@@@@@@@@@@@@@@@@@@
@@@@@@@@@@@@@@@@@@@@
@@@@@@@@@@@@@@@@@@@@
@@@@@@@@@@@@@@@@@@@@
@@@@@@.@@@@@@@@@@@@@
.@.@@@..@@@@@@@@@@@@
...@.@.@..@@@.@.@@@@
.@.....@.@@@.....@@@
.@.@.@.@..@.@.@@...@
.@@..@@@.@..@@.@.@@@
@@..@......@.@.@.@@@
@@@...@@@.@.......@@
@@..@...@...@@@.@@@.
...@..@@@@.@@@......
7
5 17 0
16 17 0
3 13 0
10 19 0
0 13 0
1 19 0
9 18 0

18 19 0
9 16 0
10 18 0
13 17 0
11 17 0
3 18 0
7 11 0
