width 20
height 20
@@@.@.@@@@@@@..@@@@@
@@@....@@@@@@.@@.@@@
@@@.@.@.@@@@.....@@@
@@@@@....@@@@.@@...@
@@@@@@.@.@@@....@@@@
@@@@@@@@.@..@.@...@@
@@@@@@....@...@@.@@@
@@@@@.@@.@@@@..@@@@@
@@@@......@...@@@@@@
@@@@@@.@.@.@.@@@@@@@
@@@@@@@........@@@@@
.@@@...@@@@.@.@.@@..
..@..@@@@..@.......@
.@.@.@.@.@..@@@.@@..
.@.....@.@.@.@.@@@.@
.@.@.@..............
...@@@@.@.@.@.@@.@.@
@@.....@@@..@@.@..@@
@@.@@@@@@..@.@.@@@@@
....@@@@@@......@@@@
7
0 13 0
8 7 0
1 12 0
8 5 0
16 16 0
2 13 0
10 17 0

9 15 0
6 8 0
0 13 0
6 4 0
4 13 0
14 12 0
19 13 0
