width 20
height 20
@@@..@...@@@.@.@@..@
@@..@.@.@@@.....@@..
@@@......@..@.@@.@.@
@@@.@@@@@..@.@.@....
@@@......@.......@@.
@@..@.@.@..@@@.@...@
@.@..@...@.@...@.@..
....@.@.@.@@@.@.@..@
.@@....@...@....@@..
...@.@.@.@@.@@@...@@
@.@@@.......@@.@@.@@
@@@@.@.@.@@........@
@@.....@@...@.@.@.@.
@.@.@@.@.@.@.@@@....
......@@.@@@..@.@.@.
@.@.@....@@@@...@@..
@..@..@.@@@@.@.@.@@.
@@@@@@..@@@.........
@@@@@@@.@...@.@.@.@.
@@@@@@@@@@.@@@...@@.
8
13 8 0
18 17 0
0 8 0
6 11 0
8 11 0
15 8 0
12 13 0
9 18 0

15 17 0
10 18 0
3 3 0
6 11 0
13 2 0
13 1 0
16 11 0
17 14 0
