width 20
height 20
..@@@@@.@@@.@..@..@@
@...@@...@@..@...@@@
..@@.@@.@@@.@..@@@@@
@.......@@....@..@@@
@@.@.@@....@@@..@.@@
@@@@..@.@.@@@.@...@@
@@.@.@.@.@@@....@..@
@..@.....@.@@.@@..@@
.@.@.@.@....@.@@@.@@
....@@@.@.@@.@.@....
.@@.@@...........@.@
.@@...@.@.@@@.@.@...
..@.@..@@@@@..@..@.@
.@.@.@@.@.@.@..@.@..
..............@@.@@@
@@.@.@.@.@@.@.@@@@@@
...@@...@@@.@@.@@@@@
.@.@@@.@.@.@.@..@@@@
.@@.@..........@@@@@
.....@.@.@.@.@.@@@@@
8
5 5 0
9 4 0
15 17 0
9 4 0
17 4 0
0 13 0
8 1 0
3 1 0

15 4 0
5 11 0
1 1 0
6 12 0
16 10 0
14 2 0
10 8 0
10 17 0
