width 20
height 20
@....@...@..@@@@@@@@
.@@.@.@@...@@@@@@@@.
.@......@@..@@.@@@..
..@.@@@....@...@@.@.
@.@@.@@.@.@..@......
.........@..@@.@@.@@
@@@@.@.@@.@.@.@@.@@@
@@....@.@..........@
...@.@....@.@@.@.@@@
@.@..@@.@..@@@@@.@@@
...@.....@......@.@.
@.@.@.@.@..@@.@.....
@@...@..@.@@@@..@@.@
@@@@..@..@@@@@@...@@
@@@@.@.@...@@@@.@.@.
@........@@.@@.@.@..
.@@.@.@@.@........@.
.....@.....@.@.@.@..
.@@.@@@.@.@.@@@....@
@@@@@...@...@@@@.@..
8
0 5 0
1 15 0
18 18 0
14 12 0
9 19 0
18 15 0
6 0 0
8 1 0

4 12 0
11 16 0
7 3 0
10 11 0
6 15 0
12 17 0
7 0 0
10 1 0
