width 20
height 20
....................
...................@
.......@............
..@........@...@....
...@.....@......@...
....................
........@....@...@..
....@.....@.@.......
....................
.........@...@..@...
.........@........@.
@...@...............
.........@.@....@...
......@.......@..@..
..@.@...............
......@.......@@....
...@.....@....@.@...
..........@.........
.....@........@.....
..........@.........
15
12 4 0
13 5 0
16 2 0
15 14 0
10 9 0
15 13 1
15 19 1
14 3 1
11 15 1
9 2 1
17 18 2
14 6 2
2 7 2
10 5 2
18 15 2

16 18 0
11 14 0
1 9 0
16 14 0
18 18 0
0 3 1
11 9 1
14 3 1
11 0 1
17 2 1
18 13 2
0 2 2
8 3 2
19 16 2
17 1 2
