width 20
height 20
@@.......@...@@@@...
@.@..........@@@@...
...@..........@@@@..
........@......@@@..
....................
....@...............
............@....@..
................@.@.
....................
........@..@........
.....@...........@..
@..@...........@....
......@..@.@..@.....
................@...
.@.@.@.......@......
....................
...@....@...........
.....@.....@........
....................
...............@@...
15
6 5 0
7 1 0
12 11 0
14 19 0
2 19 0
7 11 1
3 6 1
4 13 1
2 15 1
8 10 1
6 7 2
15 15 2
9 15 2
19 3 2
7 7 2

18 6 0
19 14 0
1 2 0
11 16 0
19 11 0
11 6 1
3 6 1
9 7 1
2 15 1
12 0 1
14 19 2
9 11 2
19 1 2
14 6 2
17 4 2
