width 20
height 20
..@@@...............
....@....@..........
................@...
..................@.
...@...........@....
@.....@..@..........
....................
....................
........@...........
@..........@........
@@.......@....@.....
@@.@....@......@....
....@.....@.........
....................
..........@..@..@...
........@...........
.........@...@..@...
.@..................
....@....@..........
...@@...@...........
15
16 1 0
7 7 0
4 13 0
3 15 0
6 3 0
18 11 1
17 13 1
5 7 1
3 14 1
15 18 1
16 10 2
19 15 2
10 17 2
19 14 2
5 18 2

5 19 0
13 6 0
4 13 0
18 0 0
15 19 0
12 11 1
16 13 1
2 1 1
19 5 1
0 3 1
6 1 2
19 17 2
7 12 2
15 10 2
12 1 2
