width 20
height 20
............@.......
....................
.......@......@.....
.....@...@........@@
...........@.......@
....................
.....@....@...@.....
...@.....@..........
...@................
....................
..........@.........
.....@.........@....
..@.@.......@....@..
....................
...........@........
..@.@.....@.@.......
.....@........@.....
..........@......@..
..@...........@.....
....................
15
8 4 0
2 0 0
17 8 0
14 14 0
16 5 0
5 19 1
10 1 1
2 1 1
4 6 1
12 17 1
9 13 2
5 4 2
7 0 2
18 12 2
0 19 2

0 15 0
14 11 0
1 15 0
6 13 0
15 4 0
9 12 1
9 13 1
16 9 1
11 9 1
7 15 1
8 14 2
9 0 2
17 19 2
14 1 2
17 13 2
