width 20
height 20
@..@................
..............@.....
.....@..@...@.......
..............@.....
..@.....@..@...@....
....................
....................
......@.@..@........
....................
...........@........
............@.......
.....@..@...........
..@.................
......@.....@...@...
..@.@...............
...........@........
....................
.........@......@...
.......@...@........
....................
15
3 3 0
11 12 0
9 4 0
11 3 0
4 19 0
12 6 1
0 8 1
18 3 1
11 17 1
1 7 1
19 7 2
0 13 2
18 7 2
13 11 2
8 1 2

18 12 0
0 3 0
1 19 0
1 3 0
15 1 0
13 1 1
15 6 1
18 3 1
15 9 1
8 9 1
18 6 2
19 3 2
19 5 2
7 3 2
0 5 2
