width 20
height 20
....................
@@........@.........
@.......@.@.......@.
@...@...........@...
@@......@.@@...@....
@@..@..@............
@@..........@....@..
........@.......@...
.....@.............@
...@................
....@......@.@.@....
....................
.........@...@....@.
............@...@...
....................
.........@..........
.......@....@..@....
.............@......
......@.............
....................
15
6 6 0
6 13 0
13 5 0
3 1 0
18 3 0
19 3 1
16 17 1
18 14 1
15 8 1
4 19 1
18 11 2
19 2 2
17 8 2
10 14 2
10 7 2

7 8 0
15 0 0
0 15 0
18 11 0
15 18 0
10 10 1
10 18 1
16 16 1
4 18 1
9 8 1
19 15 2
9 2 2
9 17 2
15 15 2
3 12 2
