width 20
height 20
..................@@
.@@.@.@.@.@.@.@.@.@@
@@@@@@@@@.@..@@@...@
@@@@@@@@@@..@.@.@.@@
@@@@@@@@@@.@.......@
@@@@@@@@@...@.@.@.@.
@@@@@@@@..@@..@.@...
@@@@@@@@.@..@.@@@.@@
@@@@@@@@@.@....@..@.
@@@@@@@@@...@.@@@@..
@@@@@@@@..@@@@@@...@
@@@@@@@@@.@.@.@.@@..
@@@@@@@@...........@
@@@@@@@@@.@@@.@.@.@.
@@@@@@@@.....@@@....
@@@@@...@.@@..@.@@@.
@@@@@@.@.@@.@.@..@..
@@@@@@.@........@.@.
@@@@@....@.@@.@@....
@@@@..@.@....@@@@.@.
10
13 6 0
15 17 0
18 4 0
12 14 0
14 4 1
16 10 1
10 19 1
13 18 2
9 14 2
9 9 2

15 4 0
10 3 0
13 16 0
13 15 0
17 4 1
15 11 1
9 12 1
18 11 2
11 12 2
14 0 2
