width 20
height 20
.........@.@.@@@@@@@
@.@@.@.@...@..@@@@@@
.@....@@@.@.@.@@@.@@
.@.@.@@@............
..@.@.@.@.@.@.@@.@.@
@.........@..@....@@
@@@@@.@@.@@@@@@@.@.@
.@@@.@.@@@@..@@.....
..@..@.@.@.@.@.@.@.@
.@@@.@..........@...
..@....@.@.@.@.@.@.@
@.@.@.@@@@..@.......
.....@@@@.@@@@.@.@.@
@.@.@.@@@.@@@.@.@...
...@@.@@...@..@..@@@
@.@.@.@.@.@.@..@.@@@
.............@....@@
@.@@.@.@.@.@...@.@@@
....@@..@.@.@.@...@@
@.@..@@@.......@.@@@
10
12 16 0
6 5 0
7 15 0
4 17 0
14 3 1
18 11 1
16 18 1
8 10 2
10 19 2
7 9 2

1 12 0
0 4 0
7 5 0
0 16 0
15 9 1
10 0 1
13 3 1
18 6 2
6 0 2
8 17 2
