width 20
height 20
...........@.@@@....
....................
......@.....@.......
....................
....@..@..@...@.....
.............@......
........@...@...@@@.
.......@............
..@...@.............
.@.......@.....@.@..
....................
.......@..........@.
..........@.@..@...@
.@..................
....................
.........@......@...
............@.......
...........@........
.........@.@....@...
................@...
11
0 9 0
2 2 0
17 7 0
2 9 0
11 15 0
13 17 0
13 1 0
10 3 0
16 10 0
10 19 0
19 14 0

1 14 0
17 19 0
7 8 0
19 13 0
7 12 0
12 17 0
10 11 0
18 15 0
2 17 0
15 7 0
6 3 0
