width 20
height 20
@...................
@@........@....@....
@@..................
....................
.@..@.......@.......
....................
...@..@..@..........
...........@........
.@...............@..
.@..@...........@...
....................
..@.................
....................
........@..@......@.
....................
....@...............
.........@..........
@......@...@........
....................
@@@@....@........@..
11
15 14 0
8 17 0
5 0 0
18 15 0
11 12 0
16 6 0
4 14 0
16 15 0
18 18 0
15 19 0
19 12 0

2 8 0
19 0 0
4 10 0
6 16 0
4 1 0
16 4 0
19 2 0
3 10 0
14 14 0
5 13 0
19 12 0
