width 20
height 20
..........@..@@@@.@.
..........@..@@@....
...@...@............
..@.................
...@...@.@..@.......
........@......@....
..@..@....@.@.....@.
.......@...@........
...@....@...........
.........@...@...@..
......@........@....
....................
......@.............
..@.................
............@.......
........@......@....
..@....@............
........@..@........
.@...@..............
@@.................@
11
5 17 0
13 4 0
7 6 0
6 2 0
8 13 0
19 7 0
0 7 0
7 3 0
7 19 0
8 4 0
0 13 0

16 3 0
4 18 0
0 18 0
9 13 0
0 0 0
5 9 0
13 6 0
6 16 0
6 6 0
1 17 0
8 0 0
