width 20
height 20
.........@..........
....................
...@....@...........
....@....@..........
.............@......
.......@@@....@.....
.............@......
.@@...............@.
@@@..@....@..@......
@@@......@..@..@....
@@..................
.@..............@...
........@@.@........
.................@..
@..@.@..............
..@....@..@.@.......
.@........@.........
......@...@.........
.................@..
........@...........
11
19 16 0
17 9 0
14 7 0
12 16 0
3 13 0
15 17 0
3 18 0
3 12 0
1 3 0
6 15 0
13 10 0

1 17 0
3 9 0
5 5 0
1 0 0
4 1 0
12 4 0
1 15 0
16 19 0
19 6 0
12 13 0
5 17 0
