width 20
height 20
@@@.....@@@....@@@@@
@@.......@..@.@@@@@@
..............@.....
................@...
@@.........@..@.....
@@...@...@..........
@........@@.........
.............@......
.@..............@...
.......@............
.....@....@.....@...
...@....@...........
.....@....@........@
@@..........@.......
@..................@
..@....@..@....@...@
.....@.....@........
.....@....@.........
..............@.....
...@................
11
13 13 0
18 4 0
17 17 0
0 16 0
7 12 0
18 8 0
2 12 0
12 9 0
4 17 0
10 5 0
5 15 0

13 15 0
16 4 0
9 14 0
3 9 0
18 13 0
19 7 0
3 18 0
0 19 0
19 4 0
10 1 0
19 17 0
