width 20
height 20
....................
....................
.........@..@..@....
..............@.....
...@................
.......@............
.....@............@.
..@.........@.......
....................
.....@...@..........
..@...@....@....@...
...@.@.....@..@.....
......@.............
.........@..........
...@.........@......
..............@.....
.@........@.......@.
........@...........
..................@@
..................@@
11
9 12 0
5 12 0
5 5 0
14 5 0
16 11 0
2 4 0
14 18 0
7 6 0
16 3 0
13 17 0
14 12 0

3 13 0
0 19 0
17 13 0
4 15 0
13 11 0
0 0 0
13 10 0
8 18 0
2 18 0
8 16 0
14 12 0
