width 20
height 20
....................
....................
..@.....@.@..@......
.......@........@...
...@.@....@.........
@@....@.............
@@.........@.@....@.
..........@....@....
.@.......@......@...
....@...............
....................
........@....@.@....
.......@..@.......@.
...@.......@@@..@.@.
......@.............
......@.............
............@..@....
.....@........@.....
......@.........@...
......@@....@.......
11
3 17 0
14 4 0
12 9 0
17 6 0
6 9 0
14 8 0
18 15 0
9 12 0
0 2 0
19 10 0
5 2 0

16 2 0
7 16 0
11 19 0
19 11 0
6 9 0
15 14 0
8 4 0
12 17 0
0 1 0
3 18 0
16 10 0
