width 20
height 20
.................@@@
..................@@
.....@.@..........@@
..........@.....@..@
...@.......@.......@
.....@..............
.........@..........
@...@...@.........@.
@.@..@.........@....
.......@......@.....
.............@......
............@...@...
.....@.........@.@..
@...................
....@........@......
.......@.@..........
....................
............@.@...@.
....................
..@..@........@.....
11
17 6 0
8 5 0
18 12 0
16 1 0
3 6 0
14 11 0
3 16 0
12 4 0
0 11 0
13 3 0
7 8 0

16 12 0
17 19 0
5 0 0
13 4 0
15 14 0
8 11 0
5 6 0
14 4 0
14 10 0
10 13 0
2 5 0
