width 20
height 20
................@@..
...@............@...
....................
.....@..............
................@...
.....@......@..@....
..@.................
....................
@....@..............
.........@...@@.....
..@.@........@@.....
...........@........
...@.....@.......@..
...................@
......@........@....
.@.......@..........
....................
........@.@.........
..@............@....
....................
6
15 17 0
10 2 0
6 7 0
1 19 0
12 9 0
4 0 0

19 9 0
4 2 0
2 7 0
6 4 0
17 9 0
19 3 0
