width 20
height 20
.....@@@@@@.........
.....@@@@@......@...
.@.....@....@..@....
..............@.....
..@......@..@.....@.
........@...........
...@................
.......@.........@..
....@...............
.........@..........
....@...............
...............@..@.
........@.........@.
.............@.@....
....................
...@.......@.@......
....................
....@.@..@..@.....@.
........@...........
@...................
6
8 16 0
16 15 0
0 7 0
15 10 0
3 0 0
3 2 0

11 2 0
11 19 0
8 8 0
16 14 0
0 7 0
3 2 0
