width 20
height 20
.......@@...........
....................
...@.....@...@.@....
.....@..............
.................@..
...@................
.@..................
.........@...@......
.....@..............
....................
...........@.@......
....................
...@................
....@.........@@@.@.
..........@...@@@...
.....@.........@@...
................@...
.........@.@.....@..
....................
@...................
6
3 7 0
8 11 0
16 0 0
3 16 0
15 3 0
17 14 0

18 19 0
8 13 0
13 1 0
12 17 0
1 11 0
18 15 0
