width 20
height 20
@.@..@@@....@@.@..@.
@.@.@..@@.@......@..
....@.@@..@@.@.@..@.
.@.@...@.@.@.@@.@...
@..@@.@.....@.....@.
@@.@..@@.@@@@@.@@..@
@....@.....@@@@.@.@.
.@.@.@.@.@@@@@......
....@.@....@@.@.@.@@
@@.@@..@.@@@@...@...
......@@@@@@@@.@.@@.
.@.@.@.@.@@@@......@
..@.......@..@@.@.@@
@@@@.@@.@...@..@..@@
.@@@@..@@.@...@.@..@
..@.@.@..@@.@.....@@
@......@.@.@.@.@.@@@
.@.@.@..........@@@@
...@@@@.@.@@.@.@@@@@
.@.....@..@...@@@@@@
2
16 4 0
8 7 0

11 15 0
2 9 0
