width 20
height 20
.......@...@.@..@@.@
@.@@.@@.@@.....@.@.@
@@.......@.@.@......
@.@.@.@.@.@...@.@@.@
...@.@.....@.@@@.@..
.@.....@.@..@.@@...@
.@@.@.@@@@@......@.@
..@.@..@...@.@@.@...
.@.@..@.@.@.@@.@.@.@
....@@@.............
.@@@...@.@.@.@.@.@.@
.....@@.@..@@@@@@.@@
@.@@.....@.........@
..@.@@.@..@.@.@.@.@@
.@....@..@.@@.@@@..@
@.@.@@.@....@@.@.@@.
.........@.@.@......
@.@@@.@.@......@@.@.
@@.....@@@.@.@...@@.
@@@@@.@@@@@...@.@@@.
2
19 2 0
1 1 0

1 16 0
10 16 0
