width 20
height 20
@.@@.@@@@@@......@@@
......@@@@.@@.@.@@@@
@.@.@.@@@......@@@.@
...@@@...@.@.@..@...
@.@.@.@.@.@...@@@@.@
..........@@.@@@@@.@
@.@.@.@.@.......@...
.@.@...@@@.@.@.@.@.@
.....@@.@.@@@@......
.@@.@@.....@...@@@.@
.@..@.@@.@..@@@@@@..
@@@....@.@.@@@@@@@@@
.@@@@.@@.@.@.@@@@@@@
.@@@....@.....@.@@.@
..@@@.@...@.@.......
.@.@.@.@.@@@..@.@@.@
.....@..@@@@@@@@@...
@@.@...@@@.@@.@.@.@@
@@@.@.@.@...........
@@........@.@@@.@.@.
2
11 2 0
13 13 0

3 16 0
18 4 0
