width 20
height 20
@@@@@@@@@@@@@.......
@@@@@@@@@@@@@@@.@.@@
@@@@@@@@@@@.....@@@@
@@@@@@@@@@@@@.@....@
@@@@@@@@@@@@@@..@@..
@@@@@@@@@@@.@.@.@..@
@@@@@@@@@.......@@@@
@@@@@@@@@@@.@@@.@@@@
@@@@@@@@@.....@@@@@@
@@@@@@@@@@@@@..@@@@@
@@@@@@@@@@@@..@.@@@@
@@@@@@@@@@@@@...@@@@
@@@@@@@@@@@@@@@..@.@
@@@@@@@@@@@@.@.@....
@@@@@@@@@@@......@.@
@@@@@@@@.@..@.@.@...
@@@@@@.@...@.@@.@@.@
@@@@.....@.@......@@
@@@@@.@@..@.@.@.@@@@
@@@@@...@....@..@@@@
1
14 11 0

14 4 0
