width 20
height 20
.........@.@@@@@@@.@
@.@.@.@.@.....@.@...
@..@@@....@.@.@..@@.
..@@@.@.@.@@...@..@.
@.....@@@@.@@.@.@.@.
@@.@@.@.@@..........
@....@.....@@.@@@@@@
@@@@@@@.@.@.@@@.@@@.
@@@@@@...@@..@....@.
@@@@@@.@.@@.@.@.@@..
@@@@@@..@.@........@
@@@@@@@.@...@.@@@.@@
@@@@@@@...@.@.@@@@@@
@@@@@@@@.@...@@@@@@@
@@@@@@@@@@@.@@@@@@@@
@@@@@@@@@@....@@@@@@
@@@@@@@@@@.@.@@@@@@@
@@@@@@@@@@@@@@@@@@@@
@@@@@@@@@@@@@@@@@@@@
@@@@@@@@@@@@@@@@@@@@
1
19 2 0

11 11 0
