width 20
height 20
@..@.@.@@@.@@@@@@@@@
@.@.....@..@@@@@@@@@
@.@.@.@@..@@@@@@@@@@
.....@@..@@@@@@@@@@@
.@@.@@.@...@@@@@@@@@
.@.@@@...@.@@@@@@@@@
....@..@@.@@@@@@@@@@
@@.@.@.@...@@@@@@@@@
........@.@..@@@@@@@
@@.@.@.@@.@.@@@@@@@@
@@@@.@......@@@@@@@@
@@@@@@@.@.@.@@@@@@@@
@@@@@@@..@@@@@@@@@@@
@@@@@@@@.@@@@@@@@@@@
@@@@@@@@@@@@@@@@@@@@
@@@@@@@@@@@@@@@@@@@@
@@@@@@@@@@@@@@@@@@@@
@@@@@@@@@@@@@@@@@@@@
@@@@@@@@@@@@@@@@@@@@
@@@@@@@@@@@@@@@@@@@@
1
7 3 0

6 6 0
