width 20
height 20
@@@@.@@.@.@.@@@.@@.@
@@@.................
@@@@@@@@@@@.@@.@.@.@
@@@@@@.....@....@@@@
@@@@@@.@.@...@.@@@@@
@@@@@@..@..@.@@@@@@@
@@@@...@@@.@@.@@@@@@
@@@@.@..@..@..@@@@@@
@@@@@..@@@.@.@@@@@@@
@@@@@@.@@.....@@@@@@
@@@@@@@...@.@.@@@@@@
@@@@@@..@@@@...@@@@@
@@@@@@@@@@@@@@@@@@@@
@@@@@@@@@@@@@@@@@@@@
@@@@@@@@@@@@@@@@@@@@
@@@@@@@@@@@@@@@@@@@@
@@@@@@@@@@@@@@@@@@@@
@@@@@@@@@@@@@@@@@@@@
@@@@@@@@@@@@@@@@@@@@
@@@@@@@@@@@@@@@@@@@@
1
10 1 0

7 10 0
