width 20
height 20
....................
..............@.....
....@..@.@..........
..@.................
.....@..............
@@.....@.@..........
....................
................@...
.@..@......@........
....................
.........@...@......
........@@..@...@...
......@.............
..@.....@........@..
...@....@@..........
....@..............@
..............@.@...
.......@............
..........@.........
................@@..
2
9 12 0
12 3 1

5 7 0
6 8 1
