width 20
height 20
..@@@@..............
..@@@..@....@.......
....................
...@................
..@....@............
.........@.......@..
...@...........@....
........@.....@.....
@....@..@...........
@...@...@........@..
@@..........@.......
....@......@.@......
....................
...@.....@..........
....@.@...@.........
................@.@.
....................
....@....@.........@
.@................@@
.................@@@
2
12 14 0
14 0 1

19 16 0
6 4 1
