width 20
height 20
....................
....@......@........
....................
....@.......@.......
@..@.....@.......@..
@@..................
@........@.@.....@..
...@...@@....@..@...
....................
......@........@....
...@.@..............
....................
..........@.........
..@...@.@...@....@..
..........@.........
......@......@......
.@..@...............
.........@..........
@...@.......@.@.....
@@@..@@.........@...
2
5 6 0
11 0 1

15 15 0
7 14 1
