width 20
height 20
..........@@.....@@@
......@.......@.....
..........@.........
......@..@..@.@.....
.@@.................
....@......@........
.@..............@...
......@..@.@........
............@.@...@.
..@.@.@.............
...............@....
..@.....@...........
..@.................
....................
..@.........@...@...
...@....@......@....
....................
....@...............
...............@....
........@...........
2
7 8 0
5 1 1

5 9 0
12 15 1
