width 20
height 20
@@@@@@@@@.@@.@......
@@@@@@@...@....@.@.@
@@@@@@@@@...@@..@...
@@@@@@@@.@.@...@@@.@
@@@@@@@....@@.@.@.@@
@@@@@@@@.@@........@
@@@.@@@@@...@.@@@@..
@@...@@...@..@@@.@.@
@.@.@.@.@..@@@@.....
..@......@.@.@@.@@.@
@.@@@.@.@..@.....@@@
@.@@...@@@.@.@.@...@
@..@@.@@.@@...@@@@@@
..@.@.@@.@.@@..@.@.@
@......@......@.....
..@@.@@..@.@@@.@.@.@
@...@@@@..@.@...@...
..@.@.@..@....@@.@.@
.@@...@@...@@.@.....
@...@..@.@..@...@@@.
4
8 15 0
19 16 0
16 11 0
1 8 0

4 15 0
9 8 0
5 14 0
15 16 0
