width 20
height 20
@@.....@@.@.@.@.@@@@
@@@.@.@.@.......@@@@
@@.@@.....@@@.@@@@@@
.....@@@.@...@@@@@@@
@.@@......@.@.@@@@@@
@@.@.@.@.@..@..@@@@@
@....@.@...@@.@@@@@.
@@.@@.@.@@@...@@@@..
........@.@.@@@@@.@.
.@.@@@@.....@.@@....
@.@@@@..@.@....@@.@.
..@.@.@..@@@@.@....@
@.......@@.@....@.@@
@@.@.@.@....@@@.@@@@
.@..@...@@@.@.@.@@@@
...@@@.@@........@@@
@@.@@....@.@@.@@@.@.
@@@@.@.@@....@@.....
@@.......@.@....@.@.
@@@@.@@@.@..@.@..@@.
4
17 18 0
7 1 0
11 5 1
12 3 2

6 14 0
0 11 0
2 9 1
13 14 2
