width 20
height 20
@@@....@.@@@........
@@@@...........@....
..@@................
......@....@........
....@........@....@.
..........@.........
.@............@.....
..........@.........
.......@..........@@
..@...........@...@@
......@......@....@@
................@..@
....@...@.........@.
....................
.....@....@........@
......@.@....@......
..@....@.......@....
....................
..@.@........@@.....
.............@@.....
14
8 3 0
14 1 0
9 10 0
1 15 0
19 6 0
6 7 0
17 1 0
11 4 0
11 1 0
14 12 0
7 4 0
16 16 0
19 7 0
8 10 0

14 15 0
10 18 0
15 9 0
15 7 0
12 16 0
8 9 0
1 3 0
9 2 0
11 1 0
13 0 0
17 13 0
4 0 0
0 16 0
19 0 0
