width 20
height 20
...@...@@@@@........
...@...@@@@@........
..@............@....
..............@.....
......@...@.....@...
....@....@.@........
...@...@............
....@...............
.................@..
.@..................
....................
....@..........@....
@............@......
@........@..........
.@@...........@.....
...@.@..@...........
..@.@............@..
....................
....@........@.@....
@..............@....
14
5 5 0
6 16 0
5 13 0
2 19 0
2 18 0
5 6 0
19 10 0
9 8 0
14 8 0
11 19 0
6 10 0
6 3 0
17 3 0
16 8 0

4 6 0
19 7 0
7 2 0
6 15 0
18 3 0
17 19 0
19 10 0
10 7 0
14 9 0
0 0 0
19 13 0
0 1 0
13 9 0
17 9 0
