width 20
height 20
...........@........
...@................
.....@...@..........
.@....@....@....@...
....................
....................
.@..................
..............@.@...
......@.....@.......
........@....@......
.....@..............
........@...@....@..
.....@..............
............@.......
.@@...@..@..........
@@@.................
@@@.@...............
@@@......@..........
@@...........@......
@@@...@@@@@...@@....
8
16 16 0
3 11 0
15 5 0
17 1 1
14 12 1
3 3 1
16 8 2
14 12 2

15 7 0
0 0 0
15 5 0
19 7 1
11 1 1
18 18 1
18 15 2
7 16 2
