width 20
height 20
@...@...............
..@.......@.........
.......@...@..@...@.
........@...@..@....
..@..@..............
....@@.....@...@....
@.......@.........@.
@..@................
............@.......
..@....@............
.....@....@.........
....@..@.........@..
..............@.....
..........@.......@.
....................
......@...@.........
.....@......@.@.....
....@.@...@....@@@@@
.............@@@@@@@
.......@@....@@@@@@@
8
4 1 0
12 6 0
0 5 0
7 13 1
5 7 1
7 18 1
13 16 2
16 4 2

1 3 0
0 19 0
18 12 0
14 1 1
19 1 1
3 2 1
12 4 2
19 6 2
