width 20
height 20
@@@@@@@@@@@@@@@@@@@@
@@@@@@@@@@@@@@@@@@@@
@@@@@@@@@@@@@@@@@@@@
@@@@@@@@@@@@@@@@@@@@
@@@@@@@@@@@@@@@@@@@@
@@@@@@@@@@@@@@@@@@@@
@.@@@@@@@@@@@@@@@@@@
..@@@@@@@@@@@@@@@@@@
@..@@@@@@@@@@@@@@@@@
.@.@.@@@@@@@@@@@@@@@
.....@@@@@@@@@@@@@@@
@.@@.@@@@@@@@.@@@@@@
...@..@@@@@@@...@@@@
@.@@@...@@@@@.@..@@@
..@@@.@..@@@..@@.@@@
@..@..@@@.@@@.@...@@
@@@@@..@@.@.@..@@...
@@@.@.@@......@@@@.@
@@....@@@.@@.@@@@...
@@@.@.......@@@@@@.@
2
17 16 0
9 15 0

6 13 0
2 9 0
