width 20
height 20
....@@@@@@@@@@@@@@@@
@@.@@@.@@@@@@@@@@@@@
@@......@@@@@@@@@@@@
@@.@.@.@@@@@@@@@@@@@
@...@@@@@@@@@@@@@@@@
.@.@@@.@@@@@@@@@@@@@
....@@..@@@@@@@@@.@@
.@.@.@.@@@.@@@@@@..@
.@@@.........@@.@.@.
.....@@.@.@.@@......
.@.@.@@@@@.@@@@.@@@.
..@.@.@@@@.....@.@@.
.@@.@..@.@@.@@...@..
......@@.@@@@@@@.@@.
@.@.@@@@..@....@....
@@......@...@@...@.@
@..@.@.@@.@.@..@@..@
@@@.@@..@..@..@...@@
@@@....@..@..@@.@.@@
@@@@.@...@@@..@.@.@@
2
9 14 0
3 12 0

8 19 0
19 10 0
