width 20
height 20
....................
....................
....................
......@.............
.....@.....@.......@
..@...@.............
.......@....@.......
.@.@..@...........@.
.................@..
......@.............
.@..................
...@........@.......
......@.........@...
...........@........
....................
.....@..@.........@.
....................
.......@........@...
...@..@.....@.......
....................
1
17 17 0

3 9 0
