width 20
height 20
.....@........@.....
....................
....................
........@....@......
@.@@@...@@..........
.........@......@...
.....@..............
...........@........
.........@.....@....
......@.........@...
..@..............@..
@...@.......@.......
.........@....@.....
......@.............
...@......@....@....
....................
..........@.........
......@......@......
@....@.@............
@..................@
1
3 8 0

4 8 0
