width 20
height 20
....................
.@.@................
....................
....................
........@..@.@......
.......@............
..@.@@...........@..
...@.....@..@...@...
......@....@........
....................
....................
.@.@..@.............
...........@........
..............@..@..
..@..@..............
...@.....@..........
...........@..@.@...
...@.@..............
...........@....@...
.@..................
1
6 18 0

17 1 0
