width 20
height 20
......@.............
....@......@........
.................@..
....................
.................@..
....@.....@..@......
.........@..........
....@...........@...
@.............@.....
@..........@...@..@.
.....@...@..........
....................
...@.@.....@........
....................
.....@..@...........
...............@.@@.
...@.@.....@.....@@@
..@....@.........@@@
...........@.@..@@@@
.....@..........@@@@
3
11 15 0
8 17 0
2 2 0

4 0 0
13 6 0
19 13 0
