width 20
height 20
@@.@.@..@@.@..@.@@@.
@..@.@.@.@..@.......
.@.@.....@.@.@@@.@.@
.....@.@......@@@...
.@.@@.@@@.@.@..@.@.@
@..@@..@@@@.@@......
@@..@@.@@@..@..@.@.@
@..@@..@@@@..@@@..@.
@@..@@.@.@..@@@@@.@.
...@@.....@.@@@@....
@.@@@@.@.@@@@@@.@.@.
@.@@.@@...@@@@@.@@@.
...@..@.@.@@@@..@.@.
@.@@@....@@.@@@.....
..@@..@.@@...@@@@.@.
@...@.@...@.@@@.@.@@
@.@....@@@@.@@......
@@..@.@@@.@.@..@@.@.
@@.@......@...@.@@..
@@@@@.@.@@..@.....@.
5
3 8 0
2 1 0
6 3 0
1 1 0
2 2 0

3 3 0
9 3 0
12 14 0
18 18 0
1 11 0
