width 20
height 20
@@@@@@@@@@@@@@@@@@@@
@@@@@@@@@@@@.@@@@@@@
@@@@@@@@@@@@..@@@@@@
@@@@@@@@.@.@.@@@@@@@
@@@@@@........@@@@@@
@@@@@@.@.@@.@.@@.@@@
@@@@@..@..@.@@.@..@@
@@@@@@.@.@.@@....@@@
@@@@@@@.......@.@.@@
@@.@@@@@.@.@.@.....@
@..@@@@..@..@@@.@@..
..@@@@..@@.@.@..@@.@
@..@@.@.@@@...@@....
@@.@....@.@.@...@.@@
.....@@......@@@....
.@.@...@@@.@@@@@@@.@
@@@@@.@.....@@@@....
@@@@@.@@.@.@@@...@@.
@@@@@@@@.@@@@@.@...@
@@@@@@@@@@@@@@.@.@@@
5
17 18 0
11 12 0
8 8 0
17 6 0
8 4 0

12 9 0
10 3 0
2 10 0
10 8 0
8 7 0
