width 20
height 20
@@@@@@@@@@@@@@@@@@@@
@@@@@@@@@@@@@@@@@@@@
@@@@@@@@@@@@@@@@@@@@
@@@@@@@@@@@@@@@@@@@@
@@@@@@@@..@...@@@@@@
@@@@@@@@@..@.@@@@@@@
@@@@@@@@@@....@.@@@@
@@@@@@@@@..@.@..@.@@
@@@@@@@@@@@....@...@
@@@@@@@@@@..@@...@@.
@@@@@@@@@@@...@.@.@.
@@@@@@@@@@@.@@......
@@@@@@@@@@@@@..@@.@.
@@@@@@@@@@@@@.@..@..
@@@@@@@@@@@@@...@@@@
@@@@@@@@@@@@..@.@@@@
@@@@@@@@@@@@@@....@@
@@@@@@@@@@@@@@@.@...
@@@@@@@@@@@@@@.@..@@
@@@@@@@@@@@@@@...@@@
5
10 5 0
13 12 0
13 4 0
8 4 0
11 9 0

15 9 0
13 10 0
14 19 0
17 17 0
16 16 0
