width 20
height 20
@......@@@@@...@.@@@
..@.@.@..@@@@@....@@
.@.@...@...@...@@@@@
...@@@..@.@@@@..@..@
.@....@....@@.@...@@
@@@.@.@.@@....@@@..@
...@@@..@@.@@.@@..@@
.@..@@@...@@..@@@...
.@.@.@@.@@..@.@@@.@.
@@......@.@...@.@.@@
@.@@.@.@....@...@.@@
......@.@.@@..@...@@
.@.@.@@.@@@.@@@@.@.@
.@@.....@...........
@@@@.@.@.@.@.@@@.@.@
@.@@@@...@@@@@@@..@@
.......@..@@@.@@.@@@
@.@@.@@@.@.@.....@@@
..@@@@.....@@.@.@@@@
.@@@@@.@.@..@..@@@@@
15
9 9 0
15 17 0
17 5 0
0 13 0
2 6 0
13 6 0
17 6 0
13 5 0
0 1 0
0 4 0
11 19 0
13 9 0
9 18 0
9 11 0
11 10 0

5 9 0
8 7 0
8 1 0
2 8 0
8 4 0
13 4 0
6 13 0
11 8 0
15 3 0
0 2 0
5 2 0
16 17 0
10 8 0
9 10 0
11 19 0
