width 20
height 20
@@@@@@@@@@@@@@@@@@@@
@@@@@@@@@@@@@@@@@@@@
@@@@@@@@@@@@@@@@@@@@
@@@@@@@@@@@@@@@@@@@@
@@@@@@@@@@@@@@@@@@@@
@@@@@@@@@@@@@@@@@@@@
@@@@@@@@@@@@@@@@@@@@
@@@@@@@@@@@@@@@.@@@@
@@@@@@@@@@@@@@....@@
@@@@@@@@@@@@@..@.@@@
@@@@@@@@@@@@@.@.@..@
@@@@@@@@@@@@@....@..
@@@@@@@@@@@@@@@.@..@
@@@@@@@@@.@.@.@...@@
@@@@@@@.......@@@..@
@@@@@@@@.@@.@..@@.@@
@@@@@@...@.@.@@@..@@
@@@@@@@.@@.@.@@.@.@@
@@@@@@@............@
@@@@@@@@@.@.@.@.@.@@
15
19 11 0
12 17 0
17 10 0
6 16 0
15 12 0
11 15 0
7 16 0
13 13 0
17 19 0
17 14 0
12 14 0
7 14 0
11 19 0
16 8 0
11 14 0

15 17 0
13 10 0
15 10 0
15 13 0
17 17 0
17 12 0
10 14 0
16 13 0
8 14 0
6 16 0
10 17 0
12 17 0
11 13 0
14 18 0
15 19 0
