width 20
height 20
@@@.@.....@@...@@...
@@..@@.@.@@..@@@@@@.
@@@..@..@.@@.@.@@.@.
@@@@..@........@....
@@@@@...@@@.@.@@@.@@
@@@@@.@@@@.@..@@...@
@@@@.@.@@....@.@.@@.
@@@@.@...@.@.....@@.
@@@....@@...@@@.@...
@.@@@@...@.@@@@...@.
.......@@...@...@@@@
@.@.@@...@.@@@.@@@@@
@@@@@@@.@..@@@@@@@@@
@.@@.@....@@@@@@@@@@
@.@@..@@@.@@@@@@@@@@
...@@..@...@@@@@@@@@
@.@.@.@@@.@@@@@@@@@@
...........@@@@@@@@@
@.@.@.@.@.@@@@@@@@@@
...@@..@@..@@@@@@@@@
15
3 16 0
2 10 0
18 8 0
12 0 0
7 11 0
9 10 0
6 2 0
9 13 0
10 17 0
6 9 0
11 6 0
9 6 0
9 18 0
10 3 0
10 9 0

3 18 0
19 2 0
12 2 0
10 8 0
1 14 0
7 17 0
18 0 0
17 2 0
12 5 0
5 0 0
1 9 0
10 10 0
5 14 0
16 3 0
9 19 0
