width 20
height 20
...@.........@.....@
.................@..
......@.......@.....
........@....@...@..
.@..............@...
............@....@..
........@..@........
.@..@..@......@.....
........@...........
...............@.@..
..........@.........
.............@......
.......@............
....................
.@.....@.....@......
.....@.....@........
..........@.........
.....@..............
........@.....@..@..
..........@.........
12
9 19 0
7 4 0
19 4 0
18 0 0
6 19 0
14 8 0
2 11 0
5 14 0
16 9 0
11 16 0
17 19 0
12 2 0

13 13 0
12 1 0
14 9 0
19 9 0
7 18 0
0 19 0
6 1 0
10 0 0
16 10 0
6 6 0
2 18 0
2 2 0
