width 20
height 20
....................
......@.@...........
...............@....
.@..@...@.@@........
......@.............
..............@.@...
.........@..........
.............@......
................@...
....@..@..@@.....@..
...........@........
.....@.....@....@...
......@.............
....................
.@.@......@...@.....
....@........@......
.....@....@.........
...@.....@...@....@.
....................
.@..................
12
13 3 0
19 10 0
19 5 0
16 15 0
14 13 0
11 13 0
15 4 0
13 16 0
8 8 0
17 2 0
13 5 0
13 11 0

3 18 0
17 2 0
11 15 0
13 11 0
9 3 0
11 14 0
19 19 0
19 9 0
8 8 0
17 5 0
12 14 0
9 8 0
