width 20
height 20
@@@..............@@.
.@@.................
........@.@.........
....................
........@.@..@......
.@.........@...@.@..
.....@..@...........
..@...............@.
....................
...........@...@....
.......@............
.@...@..@...........
............@...@...
......@.@...........
....................
..............@.....
.....@.@.......@..@.
.......@@@........@@
............@.@...@@
@........@@.........
12
2 14 0
1 16 0
12 16 0
11 6 0
1 6 0
8 3 0
14 16 0
3 0 0
12 17 0
13 6 0
3 17 0
19 10 0

1 14 0
18 12 0
3 9 0
14 12 0
17 19 0
17 18 0
12 5 0
11 14 0
3 2 0
5 0 0
8 0 0
0 13 0
