width 20
height 20
.............@......
............@@......
............@.......
........@...........
...@.....@....@@....
........@...@.@.....
................@..@
.....@.............@
..@....@.@..........
.................@..
....@.@...@..@......
....................
..................@.
....................
......@..@..@.......
....................
.@.........@........
.....@..............
...@................
....................
7
6 1 0
19 9 0
15 16 0
7 0 1
18 1 1
14 1 2
2 17 2

14 3 0
18 11 0
4 8 0
6 17 1
18 1 1
18 8 2
16 3 2
