width 20
height 20
@..@@@....@@@...@@.@
..@.@..@@.@..@.@.@..
@...@.@.@@.@.......@
.@@........@@@.@.@.@
....@.@@.@..@@@@@...
@.@..@@@@@.@@@.@.@.@
@..@@@@.@...@.......
..@@@@...@.@..@.@.@.
@@@@@@@.@....@.@.@..
@@@@@@....@@.....@@.
@@@@@@.@@@@@@.@.@@@.
@@@@@@@@@@@@@@@..@@@
@@@@@@@@@@@@@@@.@@@@
@@@@@@@@@@@@@.@..@@@
@@@@@@@@@@@.....@@@@
@@@@@@@@@@@@.@@.@@@@
@@@@@@@@@@@@@@@@@@@@
@@@@@@@@@@@@@@@@@@@@
@@@@@@@@@@@@@@@@@@@@
@@@@@@@@@@@@@@@@@@@@
5
11 8 0
17 4 0
19 9 1
12 7 1
15 12 2

12 9 0
12 2 0
10 5 1
18 5 1
16 6 2
