width 20
height 20
@@@@@@@@@@@@@@@..@@@
.@@@@@@@@@@.@..@..@@
..@@@@@@@@....@..@@@
.@@@@@@@@.@.@@@@..@@
...@@@@@......@..@@@
.@@.@.@.@@.@@...@@@@
.........@.@@@.@.@@@
.@@@.@.@....@.....@@
@.....@..@.@@@.@.@@@
@@.@@@.@.@@@@@@...@@
@..@@....@@@@@@@.@@.
.@@.@@.@@@@.@@@@@.@.
.........@@...@@@...
@@@@.@.@@.@.@@.@.@@.
@@@@@...............
@@@@@@.@@.@.@.@.@.@.
@@@@@....@.@.@...@..
@@@@@@.@@.....@.@@@.
@@@@@@@@@@.@@...@...
@@@@@@@@@@.@@@.@@@@.
5
0 6 0
0 3 0
5 5 1
12 14 1
15 4 2

10 18 0
9 17 0
10 16 1
15 18 1
10 19 2
