width 20
height 20
.@@....@..@@@@@@@@@@
....@.@.@..@@@@@@@@@
.@@@....@.@.@@@@@@@@
.@@..@.@....@@@@@@@@
@.@@.@..@@.@.@.@@@@@
@.@@..@@.@........@@
..@.@.@....@.@@.@.@@
@.......@@.@.@@@.@@@
..@.@@.@...@..@@..@@
@.@@.@@.@.@@.@...@@@
.........@.@@..@@@@@
@@.@.@.@....@@.@@@@@
@@@..@.@@.@....@@@@@
@@@@.@@@@.@.@.@@@@@@
@@@@@@@@@@.@..@@@@@@
@@.@@@@@@....@@@@@@@
....@...@.@.@@@@@@@@
@@.@@.@....@@@@@@@@@
@....@@.@.@@@@@@@@@@
..@@.....@@@@@@@@@@@
5
11 11 0
6 4 0
10 3 1
7 18 1
8 8 2

2 17 0
12 15 0
13 10 1
8 5 1
2 18 2
