width 20
height 20
@@@@@@@@..@@@@@@@@@@
@@@@@@@..@@@@@@@@@@@
@@@@@@@.@.@@@@@@@@@@
@@@@@@.....@@@@@@@@@
@@@@@@@.@.@@@@@@@@@@
@@@@@@...@@@@@@.....
.@@.@.@.@@.@@@.@.@.@
........@...@....@@@
@.@@@@@.@.@@.@.@@@@@
@@@@@@@........@@@@@
@@@@@@..@.@@.@@@@@@@
@@@@@@@..@@..@@@@@@@
@@@@@@@.@@@.@@@@@@@@
@@@@@@@..@@@@@@@@@@@
@@@@@@@.@@@@@@@@@@@@
@@@@@@@@@@@@@@@@@@@@
@@@@@@@@@@@@@@@@@@@@
@@@@@@@@@@@@@@@@@@@@
@@@@@@@@@@@@@@@@@@@@
@@@@@@@@@@@@@@@@@@@@
5
0 6 0
12 9 0
5 7 1
4 7 1
7 3 2

11 12 0
14 9 0
14 7 1
8 11 1
16 5 2
