width 20
height 20
@...@...............
@.......@...........
............@@......
.......@....@@......
....................
......@.............
...@..........@.....
............@..@....
..................@@
.......@.@........@@
....................
......@.......@.....
@...@...............
.........@..........
....................
....................
....................
...@......@......@..
.............@......
....................
2
14 15 0
11 6 0

0 8 0
14 17 0
