width 20
height 20
....................
....................
.........@....@...@.
..@.......@.........
................@...
...........@.@@.....
......@.......@.@...
..............@.....
...@...@............
....................
..@...........@..@..
......@..@..........
.@................@.
.......@........@...
@...........@....@..
...@.......@...@....
..................@.
.......@............
..........@..@......
@...................
2
17 3 0
16 1 0

4 5 0
10 16 0
