width 20
height 20
.......@...........@
...@................
........@...........
.............@..@...
..@.@....@.....@....
.....@..............
.............@..@...
.@.@...@............
....................
.......@........@...
..@..@..............
...@........@.......
........@.......@...
....................
..@....@.........@..
.............@.@....
....................
....@..@........@...
..@.......@.........
..............@@@...
10
12 10 0
14 4 0
15 10 0
8 17 0
1 0 1
12 15 1
14 0 1
16 4 2
15 14 2
3 4 2

12 9 0
0 0 0
0 14 0
12 2 0
3 18 1
10 4 1
14 0 1
9 7 2
14 18 2
7 15 2
