width 20
height 20
....................
........@....@......
....@...............
.......@...........@
...@......@...@.....
......@.............
.@...............@..
.............@......
....@.........@.....
...@.....@......@...
....................
@.......@.....@.@...
....................
.................@@@
....@.......@.@.....
......@.............
..@...........@.....
.........@..........
....................
...........@......@.
10
2 9 0
12 19 0
17 9 0
0 9 0
19 4 1
3 15 1
13 3 1
0 8 2
13 2 2
4 17 2

19 19 0
1 0 0
3 18 0
10 15 0
18 1 1
9 19 1
10 18 1
0 7 2
16 2 2
10 0 2
