width 20
height 20
....................
..@........@........
............@.......
........@...........
...........@.@..@...
...@................
......@......@......
........@...........
...@................
....@...@........@..
............@.......
..@...............@.
........@...........
......@...@.@.......
..................@.
....@.........@.....
......@........@....
.........@..........
..@........@....@...
......@...........@@
10
13 18 0
6 3 0
1 4 0
9 19 0
2 8 1
0 17 1
15 6 1
6 18 2
13 13 2
16 8 2

6 3 0
2 0 0
7 11 0
11 7 0
13 16 1
13 1 1
16 16 1
15 2 2
0 1 2
4 16 2
