width 20
height 20
@....@..............
...........@........
....................
.............@......
......@........@.@..
.@.@...@..@.........
..........@.....@.@.
....................
@@.......@..........
@@@....@.....@......
@@@@@...@........@..
@..@@.@............@
@........@.......@..
....@...............
.......@............
....@....@..........
...@..........@.....
..@.................
.........@..........
....................
10
9 0 0
10 1 0
8 11 0
0 14 0
10 15 1
18 19 1
18 8 1
15 12 2
14 8 2
8 7 2

10 8 0
0 15 0
17 14 0
16 2 0
10 9 1
2 13 1
7 10 1
15 12 2
18 12 2
8 7 2
