width 20
height 20
@..@@@@@.....@......
...@@..........@....
....................
.................@..
....................
....@...............
.......@....@....@..
....................
..@.................
........@......@....
.........@..@......@
.....@.@........@.@@
....................
....@..@..@...@.....
...@................
@...................
@@...@.....@........
@@...............@..
@@@...@.....@.......
@@@.................
10
17 4 0
9 16 0
18 14 0
6 16 0
14 12 1
7 2 1
9 14 1
4 11 2
7 3 2
5 3 2

14 10 0
19 0 0
3 11 0
18 0 0
3 2 1
5 7 1
8 7 1
18 9 2
19 17 2
0 2 2
