width 20
height 20
@.@@@@@@@.@@..@..@@@
...@@@@@..@.@...@.@@
@.@@@@@@@.....@@...@
..@@@.@.@.@@@@.@@.@@
.@.........@......@@
.@@.@@@.@.@@.@.@.@@@
..@@..@@@.@.@...@@@@
.@...@.@.....@@..@@@
.@.@....@@@.@...@@@@
....@.@.....@@@.@@@@
@@.@@@@@.@@.@....@@@
...@@@@.@.@@.@.@@.@@
.@.@@@.............@
.@@.@@@.@.@.@@.@.@.@
.....@@.@..@....@@@@
.@@@....@.@@@@.@@@@@
....@.@..@@@@@@@@@@@
.@@@@@@.@@@@@@@@@@@@
@@@@@@@@@@@@@@@@@@@@
@@@@@@@@@@@@@@@@@@@@
7
10 2 0
5 9 0
0 3 0
0 12 1
14 11 1
2 9 2
15 12 2

14 14 0
16 5 0
3 7 0
11 6 1
15 0 1
16 4 2
14 11 2
