width 20
height 20
@@@@@@@@@@@@@@@@@@@@
@@@@@@@@@@@@@@@@@@@@
@@@@@@@@@@@@@@@@@@@@
@@@@@@@@@@@@@@@@@@@@
@@@.@@@@@@@@@@@@@@@@
@@...@@@@@@@@@@@@@@@
@@@.@@@@@@@@@@@@@@@@
@....@@@@@@@@@@@@@@@
@@@@...@@@@@@@@@@@@@
@@.@.@.@@@@@@@@@@@@@
@..@@..@@..@@@@@@@@@
@@.@.@..@@....@@@@@@
@......@.@@@@...@.@.
@.@.@.@..@@...@.....
...@.@@@...@.@..@@@.
@.@......@@.@.@..@..
@...@.@@.......@@.@.
@.@.@@..@.@.@@......
@@..@@.@..@@...@.@.@
@@@.@....@@@@.@..@..
7
5 10 0
2 12 0
1 13 0
17 16 1
3 6 1
15 17 2
3 5 2

6 10 0
17 13 0
15 15 0
19 16 1
10 11 1
17 17 2
19 14 2
