width 20
height 20
@@@@@...@.@@........
.@@@@@@......@.@.@.@
.@@.@.@.@@.@..@.@@..
..........@.@@.....@
@@@.@.@.@...@@.@@@..
@.@..@..@.@..@.@@..@
....@.@@.@@.@@@@@@..
.@@.@..@.....@@@@@@.
.@.@..@@@.@.@@@@@@@.
.@.@.@.@...@@@@@@@@.
.....@.@@.@@@@@@@@@.
.@@@.....@@@@@@@@@..
...@@@.@@@@@@@@@@@@@
.@@@@@@@@@@@@@@@@@@@
@@@@@@@@@@@@@@@@@@@@
@@@@@@@@@@@@@@@@@@@@
@@@@@@@@@@@@@@@@@@@@
@@@@@@@@@@@@@@@@@@@@
@@@@@@@@@@@@@@@@@@@@
@@@@@@@@@@@@@@@@@@@@
7
11 8 0
6 10 0
11 3 0
1 5 1
0 2 1
9 10 2
6 3 2

15 0 0
3 6 0
18 3 0
1 5 1
0 2 1
19 9 2
19 11 2
