width 20
height 20
@@@@@@@@@@@@@@@.@@@@
@@@@@@@@@@@@@@@..@@@
@@@@.@@...@@@@..@.@@
@@@.....@@@@@@@...@@
@@@@.@@.@..@@@@@@.@@
@@@@@@@...@@@@@....@
@@@@@@@@@.....@@@.@.
@@@@@@@@..@.@@@@@...
@@@@@@@.@@..@@@@..@.
@@@@@@.....@@@@.@..@
@@@@@@@@.@.@@@....@@
@@@@@@@@..@.@.@.@@@@
@@@@@@@@@........@..
@@@@@@@@..@@.@.@@..@
@@@@@@@@@..@@...@.@@
@@@@@@@@@@..@@@....@
@@@@@@@@...@@@@@@.@@
@@@@@@@@@.@@@@@@@@@@
@@@@@@@@@@@@@@@@@@@@
@@@@@@@@@@@@@@@@@@@@
7
16 8 0
15 2 0
17 15 0
12 12 1
9 13 1
8 2 2
4 2 2

4 2 0
8 5 0
19 8 0
16 5 1
7 8 1
10 16 2
8 2 2
