width 20
height 20
@@@@@@@@@@@@@@@@@@@@
@@@@@@@@@@@@@@@@@@@@
@@@@@@@@@@@@@@@@@@@@
@@@@@@@@@@@@@@@@@@@@
@@@@@@@@@@@@@@@@@@@@
@@@@@@@@@@@@@@@@@@@@
@@@@@@@@@@@@@@@@@@@@
@@@@@@@@@@@@@@@@@@@@
@@@@@@@@@@@@@@@@@@@@
@@@@@@@@@@@@@@@@@@@@
@@@@@@@@@@@@@.@@@@@@
@@@@@@@@@@@@@.@@@@.@
@.@@@@@@@@@@...@@@..
.....@@@@@@..@@.@.@.
@.@@..@.@@@@........
@@@@.@..@@@.@@@@.@@@
@@@....@.@@.@@.@.@@@
@@.@.@............@@
@....@.@.@.@.@@.@@@@
@@.@..@@@@@@@...@@@@
4
9 17 0
19 12 0
11 13 1
3 18 2

7 15 0
1 14 0
13 10 1
16 17 2
