width 20
height 20
..@@@@@.@.@...@@@@@@
.@..@.......@..@@@@@
.@.@.@.@.@@@@.@@@@@@
........@.....@@@@@@
.@.@.@.@.@@.@..@@@@@
@...@.....@..@@@@@@@
.@.@@@.@@@@@@@@@@@@@
.@...@.@@@@@@@@@@@@@
...@..@@@@@@@@@@@@@@
@.@@.@@@@@@@@@@@@@@@
...@.@@@@@@@@@@@@@@@
.@@@@@@@@@@@@@@@@@@@
..@@@@@@@@@@@@@@@@@@
.@@@@@@@@@@@@@@@@@@@
..@@@@@@@@@@@@@@@@@@
@@@@@@@@@@@@@@@@@@@@
@@@@@@@@@@@@@@@@@@@@
@@@@@@@@@@@@@@@@@@@@
@@@@@@@@@@@@@@@@@@@@
@@@@@@@@@@@@@@@@@@@@
4
1 3 0
2 6 0
0 1 1
0 12 2

0 11 0
0 0 0
13 2 1
4 3 2
