width 20
height 20
......@@@..@.@@@@@@@
@@.@.@.@.@...@@@@@@@
...@.......@@@@@@@@@
@.@..@@.@@@@@@@@@@@@
@@.@.@.@.@.@.@@.@@@.
@............@...@@.
..@@.@@@@@@.@@.@@...
@...@@@@@.@..@..@@.@
@.@@@@@@....@@.@....
..@.@@@..@.@.....@@@
@....@..@....@.@.@@@
@.@.@@@.@@.@..@@.@@@
..@@@@.@.@@@@.@.@.@@
@@@@@.............@@
@@@@@@.@.@@@.@.@.@..
@@@@@@@@....@@@....@
@@@@@@..@.@..@@@.@.@
@@@@@@@...@.@@..@...
@@@@@@@@.@@@...@@.@@
@@@@@@@@.@@@@@......
4
16 13 0
1 11 0
14 10 1
16 10 2

11 17 0
2 7 0
18 8 1
14 7 2
