width 20
height 20
@@@@@@@@@@@@@@@@@@@@
@@@@@@@@@@@.@@@@@@.@
@@@@@@@@@@@.@@.@.@..
@@@@@@@@@@...@.....@
@@@@@@@@@@@.@..@.@.@
@@@@@@@@@@....@@@..@
@.@@@@@@@@@.@.@..@..
..@@@@@@@@@@...@...@
.@.@@@@@@@@..@.@.@..
...@@@.@@@@@.@@..@.@
@@..@..@@@@...@@..@@
...@@@..@@.@.@@@@@@@
@@..@.@..@....@@@@@@
@.@.....@.@.@@@@@@@@
@...@.@.......@@@@@@
@@@@..@@@.@.@@@@@@@@
@@@@@.@@@.@@@@@@@@@@
@@@@.....@@@@@@@@@@@
@@@@@.@.@@@@@@@@@@@@
@@@@@@...@@@@@@@@@@@
4
12 12 0
13 14 0
17 7 1
0 11 2

11 13 0
18 7 0
12 12 1
0 11 2
