width 20
height 20
@.@.@.....@@@@@@@@@@
@.....@@.@@@@@@@@@@@
@@.@@..@..@@@@@@@@@@
..@...@.@@.@.@@@.@@@
.@@.@.........@....@
.@@@@.@@@@.@.@.@.@..
..@@.@@.@..@......@@
.@.@......@..@.@.@@@
...@@.@.@.@@..@@@@@@
.@....@.@@@@@@@@@@@@
@@@.@.@@.@@@@@@@@@@@
.....@@...@@@@@@@@@@
@@.@...@@.@@@@@@@@@@
@..@@.@...@@@@@@@@@@
@@@.@...@@@@@@@@@@@@
@@@...@@@@@@@@@@@@@@
@@@@@@@@@@@@@@@@@@@@
@@@@@@@@@@@@@@@@@@@@
@@@@@@@@@@@@@@@@@@@@
@@@@@@@@@@@@@@@@@@@@
4
12 6 0
0 8 0
2 7 1
5 9 2

1 0 0
12 4 0
5 12 1
6 7 2
