width 20
height 20
@.@....@@@@@@@.@....
..@@@.@@@@..@@..@@@.
@.....@@@@@.@.@.@@..
@@@.@..@@@....@....@
@@@@..@@@.@.@...@@..
@@@.@.@.....@.@.@..@
@@......@@.@@@@@.@@@
@@@.@@@.@@@.@.@@..@@
@@...@.@@.......@...
@@@.@@....@.@.@...@@
@@.....@@..@...@.@@@
@@@@@@@.@.@.@.@@@@@@
@@@@@@@...@....@@@@@
@@@@@@@@.@..@.@.@@@@
@@@..@@...@@.......@
@@..@.@.@.@@@@.@.@@.
@@@.@...@..@..@.....
......@..@@..@.@.@@.
.@@.@.@@.@@.@......@
@@@@@.@@.@....@.@@..
4
7 16 0
11 3 0
3 10 1
10 8 2

5 10 0
15 18 0
9 15 1
11 9 2
