width 20
height 20
@@@@@@@@@@@@@@@@..@@
@@@@@@@@@@@@@.@.@.@@
@@@@@@@@@@@.@...@.@@
@@@@@@@@@@@...@....@
@@@@@@@@@@@@@.@@.@.@
@@@@@@@@@@@....@@...
@@@@@@..@@..@@@..@.@
@@@@@..@.@@.@@.@..@@
.@.@.@...........@.@
......@.@.@.@.@@....
@@.@.@...@..@.@.@@@.
....@@@.@@.@.@......
@.@@.@..@@@@...@.@.@
......@@.@.@.@.@@@..
.@.@.@.@.....@@@@@@@
..@@.....@@.@@@@@@@@
.@@.@.@@@@@@@@@@@@@@
@@....@@@@@@@@@@@@@@
@@@.@.@@@@@@@@@@@@@@
@@...@@@@@@@@@@@@@@@
8
4 14 0
16 9 0
3 16 0
19 10 1
17 11 1
0 16 1
12 8 2
5 9 2

14 7 0
18 4 0
10 8 0
0 11 1
2 9 1
12 8 1
5 17 2
18 5 2
