width 20
height 20
....@...........@...
....................
.......@............
............@..@....
.........@...@......
..........@.........
.............@.@..@.
.......@............
.........@......@...
..@..@......@.......
.................@@.
...@.......@....@...
.......@............
...........@........
.........@...@......
.......@......@.@...
..........@.........
...@.......@........
.................@..
................@@@.
2
10 3 0
3 9 1

10 6 0
5 1 1
