width 20
height 20
..............@@....
....................
.......@.......@@...
....................
.........@........@.
.@...........@......
....................
........@....@..@...
......@.............
......@....@........
....@..@.......@....
..........@.........
..................@.
...........@.....@..
..@.......@.........
....@...............
....@...@...........
...@@@............@.
....@@@.............
@...@@@..@@@@@@.....
2
3 14 0
5 2 1

18 0 0
5 2 1
