width 20
height 20
..@...@............@
..@...............@@
@.......@.@..@....@.
..@........@...@....
......@.............
..............@.....
...........@........
......@.............
...............@....
..@........@......@@
..............@.....
........@.@......@..
...................@
.....@....@...@....@
............@...@...
.........@..........
................@...
..............@..@..
@...................
@..@@@...........@..
2
11 14 0
5 3 1

12 8 0
4 0 1
