width 20
height 20
....................
@...............@...
@.@......@..........
@................@..
@.@.................
..........@....@....
....@@@.....@.......
.......@..@.........
......@..@..........
...@........@..@....
................@.@.
.....@@...@.........
....................
......@.............
.........@.........@
..@.......@.........
....@........@..@...
..@.....@...@....@..
...........@........
@...................
2
17 1 0
4 8 1

8 13 0
4 9 1
