width 20
height 20
..@...............@@
..................@@
.@.....@..@.......@@
.........@...@......
...............@....
....@....@..@.......
........@...@.......
......@.............
...@...............@
.@......@...@.......
.......@............
..@.................
@...................
......@..@.....@..@@
............@.......
.................@..
.....@..............
....@.@.....@.......
.........@..........
@@...............@.@
2
7 16 0
8 16 1

14 15 0
7 18 1
