width 20
height 20
..............@@....
....................
..@.........@.......
..................@.
..@@.......@....@...
..@@......@.........
...............@....
....................
..@......@...@....@.
....@...............
.@....@..@...@....@@
...@................
...@...@............
.........@......@..@
.....@..............
....@.......@@..@...
....................
....@.@...@....@.@..
....................
.......@.....@@.....
2
10 19 0
17 5 1

6 12 0
8 18 1
