width 20
height 20
@.@................@
....................
..@..@..............
......@.........@...
...@......@......@..
....................
...@......@.@.@.....
.......@.....@.@....
..@......@..........
...........@..@.....
.@..................
.....@...@.@........
...@@...............
.....@.......@......
....................
....@...@...@.......
.............@.@....
....@.@.............
.@..................
..........@@.....@@@
2
11 13 0
1 9 1

16 0 0
0 9 1
