width 20
height 20
....................
........@...........
.@.............@....
............@.@.....
...@..@...........@.
....@...............
.........@........@.
............@...@...
......@.............
...........@.......@
................@..@
.........@.....@....
..........@........@
...@.....@.........@
......@.............
...@........@..@..@.
.....@....@.........
................@@@.
.......@.........@@.
...@.............@@@
2
4 8 0
8 0 1

3 9 0
5 11 1
