width 20
height 20
.............@@.....
..................@.
....................
.......@...@......@.
...@...........@....
........@...........
..............@..@..
.......@..@.@.......
..@.................
............@.@.....
....................
.......@........@...
......@........@....
...@...@............
..............@.....
..@..@...@.......@..
......@.............
...@.....@....@.....
............@.@.....
....................
3
12 17 0
10 18 1
9 11 2

18 7 0
15 10 1
0 1 2
