width 20
height 20
....@..@........@@@@
....@.............@@
..................@@
.........@.......@..
..........@.@.......
.............@.@....
.@..................
............@.......
.......@............
...@.........@.@....
.@..................
.............@....@.
......@..@........@@
@...@.........@.....
@@....@......@......
.@...@......@.......
.........@.......@..
................@...
....................
.................@..
3
8 14 0
13 16 1
8 12 2

8 16 0
5 1 1
10 2 2
