width 20
height 20
@...................
.@.......@..........
............@..@....
......@.............
...........@.....@..
..@.................
.@....@..@...@......
....................
..@.................
....................
........@.....@.@...
....................
@.......@...........
.............@......
..........@.........
.........@..........
..@.....@...........
....@..@.@..@.....@.
.............@.....@
...................@
3
8 7 0
10 16 1
4 8 2

1 13 0
7 7 1
7 4 2
