width 20
height 20
@@.....@@@@.........
@.........@.........
@@..................
@@.........@..@....@
...............@...@
@@....@.....@......@
.@.@....@.@.........
....................
.....@......@..@....
.......@..@......@..
....................
.........@...@......
.....@..............
..........@....@....
.....@..@....@..@...
......@.............
....@.............@@
.........@.....@..@.
.....@..............
..............@.....
3
2 12 0
8 7 1
19 11 2

1 19 0
6 8 1
11 17 2
