width 20
height 20
@...@@@@@@@@@@@@@@@@
..@@@@@@@@@@@@@@@@@@
@..@@@@@@@@.@@@@@@@@
..@@@@.@.@@.@@@@@@@@
@.@@.....@@.@@@@@@@@
..@.@.@@.....@@@@@@@
.@....@@@.@@@@@@@@@@
.@@.@....@@@@@@@@@@@
.....@@.@@.@@@@@@@@@
@@.@@........@@@@@@@
@@@@@@@.@.@.@@@@@@@@
@@@@@@@@.@...@@@@@@@
@@@@@@@@...@...@@@@@
@@@@@@@@.@.@.@....@@
@@@@@@@.@...@..@.@.@
@@@@@@@.@.@..@@.....
@@@@@@.....@..@@.@@@
@@@@@@.@.@@@.@...@.@
@@@@@@@@.@@...@@....
@@@@@@@@@@@@.@@..@@.
2
18 15 0
1 3 1

1 1 0
18 17 1
