width 20
height 20
@....@@@@...@..@@@@@
@@.@.....@@...@@@@@@
@@@.@@@@....@@@@@@@@
@....@...@.@@@@@@@@@
@.@.@.@@.@@@@@@@@@@@
@..@......@@@@@@@@@@
@.@@.@.@@@@@.@.@@@@@
.....@@.@.@.....@@@@
@.@@..@.....@.@..@@@
..@@@...@.@.@@..@@@@
@@.@..@.@.@...@.@@@@
@@.@@..@.@..@@..@@@@
@..@@@...@@...@.@@@@
..@....@@...@.@.@@.@
@.@.@.@...@.@@......
....@@@@.@..@..@.@.@
@@.@.@@@@.@.@@.@..@@
......@....@.@@@.@@@
.@.@.@@.@.@...@@..@@
.@@.....@@..@....@@@
2
3 19 0
11 14 1

7 10 0
11 11 1
