width 20
height 20
@@@@@@@@@@@@@@@@@@@@
@@@@@@@@@@@@@.@.@@@@
@@@@@@@@@@@@....@@@@
@@@@@@@@@@@@.@@.@@@.
@@@@@@@@@@@@@@@..@..
@@@@@@@@@@@@@@.@...@
@@@@@@@@@@@@@....@..
@@@@@@@@@@@@@@@.@..@
@@@@@@@@@@@@@@@@@@..
@@@@@@@@@@@@@@@.@.@.
@@@@@@@@@@@@@@@.....
@@@@@@@@@@@@@@.@.@.@
@@@@@@@@@@@@...@.@..
@@@@@@@@@@@@@@....@@
@@@@@@@@@@@@.@.@@@..
@@@@@@@@@@@@...@@.@.
@@@@@@@@@@@@.@......
@@@@@@@@@@@@@..@@.@.
@@@@@@@@@@@@@@@@@@..
@@@@@@@@@@@@@@@@@@@.
2
19 19 0
19 14 1

19 18 0
15 9 1
