width 20
height 20
@...................
@.....@....@........
.........@....@.....
.@..................
.....@..............
...........@......@.
.@....@.....@......@
............@...@@.@
.......@.@......@@.@
....@............@.@
.@...@.@............
..........@@........
...@.@..............
..@....@........@...
..........@..@......
....................
...@......@......@..
....................
..@.....@.@@@.......
..........@@@......@
8
14 9 0
17 3 0
14 9 0
10 13 0
15 14 0
9 17 0
10 0 0
2 8 0

0 15 0
4 13 0
15 9 0
13 18 0
7 12 0
14 9 0
10 15 0
3 11 0
