width 20
height 20
@@@@..@.@.@@@@.@@@@@
@@@.@.@.....@...@@@@
......@@.@.@.@.@@@@.
@.@.@@@.@.......@...
@@...@...@.@.@@..@@.
@.@.@.@@.@@@@...@@@.
..............@.@@@.
@@@.@.@@@.@.@.@@@@..
@@...@..@@.@@@..@.@.
@@@.@.@.....@@@.....
@@@.....@@.@.@..@.@.
@@@@.@@@......@@..@.
@@@@@.@@@@.@.@@.@.@.
@@.@...@.@..@......@
@@...@.@...@@@.@@.@@
@@.@@@@@.@.@@..@...@
....@@.@.@@.@.@..@@@
@.@......@...@.@..@@
..@@.@.@...@.....@@@
@@....@..@.@.@.@..@@
6
3 6 0
5 6 0
7 17 0
10 18 0
5 9 0
9 18 0

16 13 0
16 9 0
10 6 0
13 3 0
16 16 0
14 2 0
