width 20
height 20
@@@@@@@@@@@@@@@@@@@@
@@@@@@@@@@@@@@@@@@@@
@@@@@@@@@@@@@@@@@@@@
@@@@@@@@@@@@@@@@@@@@
@@@@@@@@@@@@@@@@@@@@
@@@@@@@@@@@@@@@@@@@@
@@@@@@@@@@@@@@@@@@.@
@@@@@@@@@@@@@@@@@@..
@@@@@@@@@@@@@@@@@..@
@@@@@@@@@@@@@@@@..@@
@@@@@@@@@.@@@@@@@.@@
@@@@@@@@@..@@@@@@..@
@.@@@@.@@.@.@.@...@.
...@@@........@.@.@.
@@....@.@.@.@....@@.
...@.@@..@@@.@@.@@..
@.@.@.@.@@@..@..@.@.
........@...@@@.....
@.@.@.@.@@@.@..@@@@.
..@..@.......@......
6
7 15 0
11 18 0
15 14 0
16 14 0
14 18 0
17 12 0

15 19 0
13 12 0
1 12 0
14 19 0
2 15 0
6 12 0
