width 20
height 20
.......@..@@@@@@@@@@
.@@@.@@..@@@@@@@@@@@
..@@@@@.@@@@@@@@@@@@
.@.@.@...@@@@@@@@@@@
.......@@..@@@@@@@@@
@@@.@@..@.@.@@@...@@
..@@...@.....@..@.@@
@...@@...@@.@.@..@@@
..@@..@.@@......@.@@
@..@.@....@.@.@.@...
.@....@.@.@.@@....@.
...@.@@..@@@@.@.@..@
@@..@@@.@......@@@..
...@.@...@@.@@.....@
.@....@.@.@@@@@.@@..
@@@.@.......@@@...@@
@@@@@.@.@@.@..@.@...
@@@@@..@@@@.@..@..@.
@@@@@@..@....@.@.@..
@@@@@@@...@.@.....@.
6
7 5 0
0 13 0
5 8 0
19 9 0
2 12 0
17 8 0

17 13 0
13 9 0
11 12 0
6 3 0
12 16 0
0 8 0
