width 20
height 20
@@@...@.@.@@.@.@@@..
@@@@@......@......@.
@@@@@.@.@.@.@.@.@.@.
@@@.@.@@@....@...@..
@@....@...@.@@@.@.@.
@.@@@.@@@.@..@......
......@@@@@@..@.@.@.
.@.@@@@.@.@.@@.@.@..
@@.@.@.............@
.......@.@.@.@.@.@.@
@@.@.@..@@@.@.@.@.@.
....@.@@@@..........
.@.@..@.@.@.@@@.@@.@
..@.@.......@.@@@..@
.@@...@.@.@......@..
.@@@@.@@@@..@.@@@..@
..@.@@@@@.@@.@.@.@..
@..................@
..@.@@.@.@@.@.@.@@..
@.@...@...@@@@@@...@
6
14 16 0
8 19 0
2 8 0
18 17 0
18 17 0
4 0 0

8 9 0
5 15 0
13 15 0
16 3 0
0 7 0
11 11 0
