width 20
height 20
@@@@@@@@@@@@@@@@@@@@
@@@@@@@@@@@@@@@@@@@@
@@@@@@@@@@@@@@@@@@@@
@@@@@@@@@@@@@@@@@@@@
.@@@@@@@@@@@@@@@@@@@
.@@@@@@@@@@@@@@@@@@@
...@@@@@@@@@@@@@@@@@
.@@.@@@@@@@@@@@@@...
.....@@@@@@@@....@.@
@@@.@.@@@@@@@@.@.@..
......@@@@.@.@@....@
@@.@@...@..@.@.@.@@@
@@@...@..@........@@
@@@@@..@.@@@.@.@.@@@
@@@@@@.@......@@@@@@
@@@@@@.@.@@@@.@@@@.@
@@@@@@@@.@.@.@.@@...
@@@@@........@.@.@.@
@@@@@@@@.@.@........
@@@@@@@@@@@@@@@@.@.@
5
16 11 0
18 9 0
10 16 1
16 13 1
15 12 2

14 11 0
12 17 0
5 12 1
19 16 1
12 18 2
