width 20
height 20
.@@..@@........@@...
....@@@.@.@@@.@.@.@@
@@.@@@.@..@.@.......
@...@...@....@@@.@.@
.@.@..@@..@.@@@@@@.@
.....@.@.@...@@@....
.@.@.@.@@..@@...@.@.
@..@....@.@@.@.@.@..
..@@@.@...........@@
.@@@@.@.@.@.@.@.@.@@
@@@.@@...@...@..@@.@
@@@.@@.@@@@.@.@@....
@.@..@@.@........@@.
....@.@..@.@@.@.@...
@.@.....@.@...@@.@@.
...@@.@.....@.@@...@
@@...@@@@.@..@@.@.@@
...@..@@@@@@.......@
@.@@.@@@@@@@@@.@.@..
....@@@@@@@@@@@...@.
5
4 6 0
0 8 0
19 5 1
15 9 1
5 14 2

4 5 0
1 5 0
17 19 1
18 17 1
11 2 2
