width 20
height 20
@@@@@@@@@...@@@@@.@.
@@@@@@@@@@.@@@@@....
@@@@@@@@@@.@@@@..@.@
@@@@@@@......@@@@...
@@@@@@@@.@.@@@@@@@@.
@@@@@@@@@.....@@....
@@@@@@@@@@.@.@...@@@
@@@@@@@@@@@....@@@@@
@@@@@@@@@@@@.@.@@@@@
@@@..@@@@@@@@...@@@@
@@..@.@@@@@@.@.@.@@.
@.@...@.@@@.........
@.@.@...@@@@@.@.@@@.
..@.@@.@@@@@@..@@@..
@...@.@@.@.@.@@@.@@.
.@@...@.............
....@..@.@@@.@@.@@.@
.@@..@.@....@.@.@@@@
..@.@....@.@@....@@@
@..@@@.@@..@..@.@@@@
5
19 13 0
14 11 0
8 17 1
14 7 1
13 17 2

3 16 0
18 16 0
13 12 1
10 14 1
14 6 2
