width 20
height 20
@@@@.@@@@@@@@@.@@@..
@@@....@@@@@@...@.@.
@@@@@.@.@@.@..@@....
@@@@..@.@...@..@@.@.
@@.@@....@@.@.@....@
@..@.@.@@.@.....@.@@
@.@........@@.@@..@@
...@.@@.@.@.....@.@@
.@....@@....@@@.@.@@
@@.@.@@@@.@..@@@@@@@
....@@@@@@..@.@@@@@@
@.@@@@@@@@@....@@@@@
@@@@@@@@@@@.@@...@@@
@@@@@@@@@@@@...@.@.@
@@@@@@@@@@@@@.@.....
@@@@@@@@@@@.@.@@.@@@
@@@@@@@@@@@.....@@.@
@@@@@@@@@@@@@@.@.@.@
@@@@@@@@@@@@........
@@@@@@@@@@@@@.@.@.@.
5
15 5 0
17 4 0
15 7 1
4 6 1
17 6 2

8 4 0
16 14 0
19 18 1
15 12 1
18 17 2
