width 20
height 20
@@@@..@@@@@@@@@@@@@@
@@@..@@@@@@@@@@@@@@@
@@@@..@@@@@@@@@@@@@@
@@@..@@@@@@@@@@@@@@@
....@@@@@@@@@@@@@@@@
@.@@@.@@@@@@@@@@@@@@
@......@@@@@@@@@@@.@
..@.@.@@@@@@@.@@@...
@..@.@.@@@@@.....@.@
@@......@.@.@.@@....
@@.@.@.@.......@.@.@
..@@@....@@@.@..@@@@
.@@@@@.@@@@@@..@@@@@
.@@@@@@@@@.@@@..@@@@
..@..@@@@@..@@@..@@@
@..@..@.@.@.@.@.@@@@
@.@..@...........@@@
....@.@.@.@.@.@.@@@@
@.@...@..@..@@@@@@@@
@@@@@...@@@.@@@@@@@@
11
2 17 0
3 16 0
17 7 0
1 6 0
9 16 1
13 16 1
3 6 1
3 4 1
13 7 2
2 6 2
9 9 2

1 8 0
0 7 0
1 14 0
0 12 0
17 9 1
3 3 1
11 9 1
9 16 1
17 7 2
1 11 2
11 15 2
