width 20
height 20
@@@@@@@@@@@@@@@@@@@@
@@@@.@@@@@@@@@@@@@@@
@@@..@@@@@@@@@@@@@@@
..@@..@@@@@@@@@@@@@@
@.@@.@@@@@@@@@@@@@@@
..@...@@@@@@@@@@@@@@
@.@.@..@@@@@@@@@@@@@
@....@@@@@@@@@@@@@@@
..@@.@@@@@@@@@@@@@@@
.@....@@@@@@@@@@@@@@
..@@.@.@@@@@@@@@@@@@
.@@....@@@@@@@@@@@@@
..@@.@..@@@@@@@@@@@@
.@@@@.@.@@@@@@@@@@@@
...@....@@@@@@@@@@@@
.@@@.@@..@@@@@@@@@@@
@@.@.@.@..@@@@@@@@@@
@@......@@@@@@@@@@@@
@..@.@.@.@@@@@@@@@@@
@@..@....@@@@@@@@@@@
11
0 8 0
6 11 0
4 14 0
2 16 0
0 13 1
4 1 1
3 6 1
8 16 1
1 4 2
3 7 2
6 18 2

0 5 0
4 9 0
1 3 0
4 18 0
0 13 1
8 16 1
6 17 1
5 13 1
0 9 2
4 14 2
6 18 2
