width 20
height 20
@@@@@@.....@@@@@@...
@@@@@@@.@@..@@@@@.@@
@@@@@...@@.@@@@.....
@@@@@@@.@..@@...@@@.
@@@@@@@@.@.@..@...@.
@@@@@@@......@@.@.@.
@@@@@@@@.@.@...@...@
@@@@@@@@.@..@@@.@.@@
@@@@@@@@..@@@@.....@
@@@@@@@..@.@@.@@.@..
@@@@@@..@@.@@..@@..@
@@@..@@......@...@.@
@@..@@.@.@.@.@.@@...
@.@..@....@..@.@.@@@
....@.@.@@@@.....@@@
@@@.......@.@.@@@@@@
....@.@.@....@@@@@@@
@@@.@.@@..@.@@@@@@@@
....@@@@@..@@@@@@@@@
@.@..@@@@@.@@@@@@@@@
14
13 14 0
19 5 0
17 0 0
8 17 0
16 6 0
15 7 1
11 17 1
10 11 1
4 19 1
5 15 1
3 18 2
18 8 2
0 14 2
6 0 2

12 12 0
6 15 0
13 3 0
18 12 0
18 2 0
17 1 1
19 3 1
15 2 1
11 13 1
4 15 1
10 12 2
1 18 2
5 2 2
3 17 2
