width 20
height 20
..@@@@.@@@@.@.@@@.@@
.@.@...........@...@
....@.@@@@.@@.@.@.@@
@.@.......@@....@.@@
..@.@.@@.@..@.@.....
.@@..@..@..@@@@.@.@@
.@@@.@@...@@@.@@..@.
@.@@.@.@.@@@..@.@...
@.........@@@.....@.
.@@.@@.@@....@.@@@@@
......@...@.@.@@.@@@
.@@.@.@@.@.....@.@@@
@@.@..@.@@@.@.@@.@@@
....@.@.@@@@........
.@.@@.@.@.@@@.@.@.@.
@..........@@@...@@.
.@.@.@@.@@@....@@@@@
....@@@.@@..@@@@@@@@
.@.@@.....@...@@@@@@
@..@..@@@..@@@@@@@@@
14
16 15 0
7 13 0
19 15 0
11 10 0
7 18 0
5 15 1
12 1 1
5 1 1
2 18 1
15 3 1
13 11 2
4 6 2
0 17 2
13 13 2

13 16 0
7 8 0
4 15 0
7 5 0
1 10 0
13 18 1
5 4 1
11 18 1
8 6 1
8 18 1
3 8 2
8 15 2
0 4 2
14 15 2
