width 20
height 20
..............@@....
......@.....@.......
....................
........@...........
...@...@.....@....@.
..............@....@
......@............@
.....@..............
............@.......
....@..@..@..@...@..
.@...@..............
..@.......@...@.....
.............@......
....@...@...........
....................
...@......@.........
...@..@.............
...@...........@....
.........@.@........
....................
11
6 10 0
5 9 0
16 5 0
4 16 0
14 3 1
5 12 1
11 11 1
10 2 1
2 19 2
17 1 2
18 5 2

7 10 0
5 4 0
15 6 0
14 3 0
4 16 1
14 1 1
0 6 1
13 2 1
16 0 2
18 10 2
4 17 2
