width 20
height 20
...................@
..@..@..............
.......@............
....@.......@..@.@..
......@...........@.
.........@.......@..
...........@........
..@....@............
..@.............@...
.....@......@.......
....................
.@..@..@...@.....@@@
...................@
.....@...@.....@....
....................
....................
..@....@...@.@......
.@......@...@.@.@...
....@...............
....................
11
12 11 0
12 13 0
9 4 0
5 0 0
0 4 1
4 15 1
13 10 1
2 5 1
9 11 2
16 10 2
7 17 2

11 10 0
5 10 0
15 10 0
17 9 0
14 0 1
18 6 1
6 0 1
5 5 1
8 13 2
12 10 2
0 12 2
