width 20
height 20
..................@@
....................
...........@..@....@
............@......@
.....@..@...........
............@.@.....
...@..@......@..@...
.......@............
...........@......@.
..@@...@............
@@@@.........@......
@@@........@......@.
@@@..............@..
@@@@..........@.....
@@@..@.....@.@.@....
@...@...............
............@.......
.....@.@............
@................@..
@...................
11
19 8 0
0 7 0
8 12 0
11 18 0
5 16 1
9 5 1
11 4 1
13 5 1
14 10 2
4 12 2
7 10 2

19 7 0
0 7 0
0 9 0
5 8 0
18 5 1
9 12 1
6 13 1
3 1 1
1 3 2
14 4 2
6 10 2
