width 20
height 20
...@................
.....@..............
....................
...@.@..........@...
........@.......@...
......@...........@.
....@.....@.@.......
....@.@........@....
...........@..@.....
@........@..........
.....@..............
..@....@......@....@
........@..........@
..@...............@@
...............@...@
..@...@......@......
....................
............@....@..
..@.........@.......
.....@......@@......
11
12 15 0
1 11 0
7 15 0
9 19 0
19 15 1
4 9 1
10 7 1
11 14 1
8 3 2
2 8 2
7 0 2

18 15 0
5 16 0
8 14 0
14 7 0
7 12 1
16 10 1
12 11 1
11 17 1
7 3 2
4 9 2
18 12 2
