width 20
height 20
...........@@.....@@
..........@@@.......
..........@@@@.....@
...................@
....@......@@.......
...@........@.......
..@.........@......@
....................
..........@.........
..@.................
..................@.
....@.@......@......
.......@......@.....
@............@......
..@........@.....@..
....@..............@
.@...@...@..........
............@...@...
............@......@
...........@@.....@@
11
3 16 0
9 8 0
11 11 0
8 2 0
19 9 1
9 15 1
10 15 1
5 10 1
0 8 2
2 5 2
0 6 2

15 17 0
19 14 0
0 0 0
10 19 0
0 4 1
1 9 1
9 18 1
5 0 1
8 6 2
15 11 2
7 15 2
