width 20
height 20
.............@......
....................
..@.................
@................@..
......@.............
....................
....@.....@.........
.......@.........@..
.......@............
....@.@..@..........
.........@....@.....
.................@..
...@...@..@....@.@..
...........@...@@...
.............@@@....
......@.............
....@....@.@........
...........@..@..@..
@...................
@.@..@@............@
11
0 5 0
4 18 0
19 13 0
1 11 0
6 2 1
12 9 1
3 19 1
9 17 1
5 4 2
1 17 2
15 8 2

3 5 0
13 1 0
14 2 0
3 6 0
18 14 1
12 3 1
0 1 1
17 5 1
11 14 2
16 18 2
3 18 2
