width 20
height 20
@.............@.....
..........@...@.....
....................
..............@.....
....................
.......@............
.@..................
....................
............@...@...
@@.@................
.......@..@.........
....................
....@......@..@..@..
@...........@.......
...................@
....@.............@@
..@....@.........@@@
......@....@..@..@@@
...........@........
.............@......
7
7 0 0
5 12 0
5 5 0
19 9 0
1 17 0
0 7 0
13 1 0

17 14 0
7 11 0
12 3 0
18 14 0
1 13 0
19 0 0
1 19 0
