width 20
height 20
@@......@...........
@......@....@.......
@....@............@.
....................
................@...
.........@@......@..
....................
.............@..@...
@.....@...@.........
....................
..........@..@.@..@.
@@..@...............
...@....@.......@...
..........@.........
.@....@.@...........
...@...........@....
....................
@...@...@..@........
....................
....................
7
5 17 0
3 19 0
13 5 0
6 12 0
15 12 0
19 16 0
1 5 0

13 4 0
3 17 0
2 16 0
7 12 0
3 1 0
9 13 0
0 6 0
