width 20
height 20
...@@.....@@@@......
.@......@.@.........
....................
...@.............@..
..@..@.......@......
....................
.......@....@.......
.@..................
@...@...............
...........@........
.........@..........
.....@...........@..
............@.......
....@.@..@..........
.................@..
......@............@
.......@...........@
..@.........@...@...
............@.......
....................
2
0 17 0
12 16 0

3 5 0
17 10 0
