width 20
height 20
..@.................
..@................@
........@..........@
.....@.......@.@....
........@........@..
.@..........@.......
......@.............
.............@......
..................@.
............@.......
................@...
.....@..............
........@..@........
..@..........@...@..
..@@................
...@................
....................
......@..@@..@..@...
.........@@.........
.........@@.........
2
8 19 0
13 1 0

19 4 0
11 6 0
