width 20
height 20
..@@................
...@..@.............
....................
...@.....@..........
...........@@......@
..@...@....@@...@...
......@.@..@....@...
...............@....
..............@...@.
.........@..........
..@.................
...@.......@......@@
......@.....@.@.....
@........@.....@....
....@...............
.............@....@.
....................
............@.@.....
................@...
...................@
2
2 14 0
1 10 0

9 18 0
13 11 0
