width 20
height 20
@@........@@.@.@...@
.@.@.@@.@.@..@.@.@..
.@@..@@@...@.@....@.
..@@.@@@@@.....@.@.@
.@.@..@....@.@.@@@..
.@..@@.@.@.@@.@...@.
..@.@..@..@.@.@@@...
@....@...@..@...@.@.
..@@@..@..@..@.@...@
@....@..@@.@.....@@.
..@@.@@......@.@....
@..@..@.@.@.@.@..@@@
@.@..@.@@@.@...@....
@@.@.........@.@.@.@
@....@.@.@@.@...@...
@.@@..@.@@...@.@@@.@
@@@@@...@.@@@.@@.@.@
@@@@@@@.@...........
@@@@@@@.@.@@.@.@@@.@
@@@@@@@.....@@@@@@@@
4
14 7 0
14 8 0
11 1 0
12 1 0

16 8 0
13 17 0
1 15 0
3 5 0
