width 20
height 20
.@@.@....@.........@
.@....@@...@@.@.@@..
...@@.@.@.@@@@...@.@
@@...@...@.@.@@.@@@@
@@.@...@@....@...@@@
@.@..@@...@.@.@@...@
....@@@@@@.......@..
.@@...@@@.@.@.@@@..@
...@@.@@@.@..@@@@@@@
.@@..@@@....@@@@@@@@
....@@@@@.@.@@@@@@@@
@@@@@@@@@@..@@@@@@@@
@@@@@@@@@..@@@@@@@@@
@@@@@@@@@@@@@@@@@@@@
@@@@@@@@@@@@@@@@@@@@
@@@@@@@@@@@@@@@@@@@@
@@@@@@@@@@@@@@@@@@@@
@@@@@@@@@@@@@@@@@@@@
@@@@@@@@@@@@@@@@@@@@
@@@@@@@@@@@@@@@@@@@@
8
2 1 0
14 4 0
4 3 0
15 2 1
16 2 1
11 8 1
3 6 2
18 5 2

4 9 0
3 6 0
4 7 0
9 5 1
0 7 1
1 8 1
3 3 2
7 2 2
