width 20
height 20
..@@@@@@@@@@@@@@@@@@
.@.@@.@@@@@@@@@@@@@@
......@@@@@@@@@@@@@@
.@@.@..@@@@@@@@@@@@@
@@@@..@@.@@@@@@@@@@@
.@.@.@@...@@@@@@@@@@
......@.@@@@@@@.@@@@
.@@.@.......@...@@@@
.@.@@@.@.@.@.@.@@@@@
...@@.@.@.@....@@@@@
@@..........@.@@@@@@
@@@.@.@@@.@..@@@@@@@
@@@@@@@@@..@.@@@@@@@
@@@@@@@@@@..@@@@@@@@
@@@@@@@@@@.@@@@@@@@@
@@@@@@@@@@@@@@@@@@@@
@@@@@@@@@@@@@@@@@@@@
@@@@@@@@@@@@@@@@@@@@
@@@@@@@@@@@@@@@@@@@@
@@@@@@@@@@@@@@@@@@@@
8
0 2 0
2 2 0
10 8 0
6 10 1
14 8 1
0 5 1
8 7 2
12 12 2

5 4 0
6 7 0
0 6 0
0 5 1
12 8 1
15 6 1
14 7 2
3 6 2
