width 20
height 20
@@@@@@@@@@@@@@@@....
@@@@@@@@@@@@@@@.@.@@
@@@@@@@@@@@@@@....@@
@@@@@@@@@@@.@.@.@...
@@@@@@@@@@.......@@.
@@@@@@@@@@@@.@.@.@@.
@@@@@@@@@@@@..@@@@@@
@@@@@@@@@@@@.@@@.@@.
@@@@@@@@@@@@..@...@.
@@@@@@@@@@@@.@.@.@..
@@@@@@@@@@@........@
@@@@@@@@@@.@@@.@@@..
@@@@@@@@@.......@..@
@@@@@@@@@@@@@@@..@..
@@@@@@@@@@@.....@.@.
@@@@@@@@@@@@.@.@....
@@@@@@@@@@@...@@.@@.
@@@@@@@@@@@@.@@@@@@@
@@@@@@@@@@@@@@@@@@@@
@@@@@@@@@@@@@@@@@@@@
8
15 4 0
15 3 0
17 8 0
12 4 1
17 12 1
13 8 1
16 10 2
13 3 2

19 5 0
12 9 0
14 12 0
15 8 1
17 2 1
19 0 1
17 3 2
17 15 2
