width 20
height 20
@@.@.@@.@@@@..@@@@..
@.......@@@@@..@@..@
@@.@.@@..@@@.@.@.@.@
@@@..@@@.@@.........
.@.@.@@.@@.@.@@.@.@.
...........@...@...@
@.@.@@@.@.@.@.@@@.@@
@@@@..@.@......@.@@@
@@@@@....@.@.@.@.@.@
@@@@@.@@..@@@......@
@@@@@@@@@..@..@.@.@.
.@@@.@@.@.@@@..@....
..@.....@..@.@.@@.@@
.@.@.@@@@@...@..@@..
.......@@@.@.@.@...@
@.@@.@..@@@...@@.@@@
@..@.@@@.@@@.@.@...@
..@@..@..........@@@
@...@...@.@.@.@@....
@@.@..@..@@@..@..@.@
8
16 18 0
12 4 0
17 1 0
16 17 1
18 13 1
4 16 1
1 6 2
3 14 2

14 11 0
2 1 0
17 1 0
8 19 1
4 13 1
3 6 1
1 6 2
9 12 2
