width 20
height 20
@.@...............@@
@.@.@@.@.@.@@.@.@..@
....@@.@..@@@@@@@.@.
@.@..@@..@@@@@@.....
..@@.@@@..@@@@@.@.@.
@..@@.@..@@@@@...@..
.@.@..@@@@@@@@@@@.@.
...@.@..@.@@@@@.....
@@....@....@@@.@@.@.
@.@@.@..@.@@@.....@.
..@...@.@.@@.@.@.@..
@.@@@....@......@@@.
...@..@.@@@@.@.@@@@.
@@...@@@@@@@@....@@@
@@.@....@@@@@@@@@@@@
@@@@@.@.@@@@@@@@@@@@
@@@@@@@@@@@@@@@@@@@@
@@@@@@@@@@@@@@@@@@@@
@@@@@@@@@@@@@@@@@@@@
@@@@@@@@@@@@@@@@@@@@
4
8 5 0
12 10 0
17 6 0
6 0 0

6 7 0
18 7 0
0 7 0
15 5 0
