width 20
height 20
@@@@@@..@@..@.@@.@@@
@@@@@@@..@.@.....@@@
@@@@@@@.@..@.@.@@.@@
@@@@@.....@.@@.....@
@@@@@.@.@......@.@.@
@@@@@@.@@@.@@@.@..@@
@@@@@@.....@@..@@@.@
@@@@@@@@.@.@..@@@...
@@@@@@@@..@@.@@@@@.@
@@@@@@..@@@...@@@..@
@@@@@@@.@..@@.@...@@
@@@@@@@...@.@.@.@@@@
@@@@@@@@@.@.........
@@@@@@@@....@@.@.@.@
@@@@@@@@@@.@.@..@@@@
@@@@@@@@@.@....@@@@@
@@@@@@@@...@.@...@@@
@@@@@@@@.@...@.@..@@
@@@@@@@..@@@..@@.@@@
@@@@@@@@.@@..@@...@@
4
14 3 0
18 4 0
19 12 0
12 9 0

14 12 0
9 10 0
15 11 0
12 12 0
