width 20
height 20
..@@...@@.@..@@.@@@@
@..@.@.....@..@..@@@
.@...@@@.@@@@.@.@.@@
.@@.@.@.@.@........@
.@..........@.@@@.@.
.@.@@.@.@.@..@@.....
.@..@@.@.@@@@@@@@@@@
...@@@...@@@@@@@@@@@
@.@@@.@.@@@@@@@@@@@@
..@.....@@@@@@@@@@@@
@...@@@@@@@@@@@@@@@@
@@@..@@@@@@@@@@@@@@@
@@..@@@@@@@@@@@@@@@@
@..@@@@@@@@@@@@@@@@@
@@..@@@@@@@@@@@@@@@@
@..@@@@@@@@@@@@@@@@@
@@@@@@@@@@@@@@@@@@@@
@@@@@@@@@@@@@@@@@@@@
@@@@@@@@@@@@@@@@@@@@
@@@@@@@@@@@@@@@@@@@@
4
4 0 0
11 5 0
4 4 0
17 3 0

8 7 0
4 11 0
0 5 0
17 5 0
