width 20
height 20
@@@@@@@@@@@@@@@@@@@@
@@@@@@@@@@@@@@@@@@@@
@@@@@@@@@@@@@@@@@@@@
@@@@@@@@@@@@@@@@@@@@
@@@@@@@@@@@@@@@@@@@@
@@@@@@@@.@..@.@.@@@@
@@@@@@@...@.@....@@@
@@@@@@@@@.....@.@@@@
@@@@@@@...@.@.@.@@@@
@@@@@..@.@.@...@@@@@
@@@@@@.@...@@.@@@@@@
@@@@@....@.@.@@@@@@@
@@@@@.@.@.....@@@@@@
@@@@@..@@.@@.@@@@.@.
@@@@@@@@@..@..@@..@.
@@@@@@@@@@@@@.@.@...
@@@@@@@@@@.@......@.
@@@@@@@@@...@.@.@@..
@@@@@@@@@@@....@@@@@
@@@@@@@@@@..@@...@@@
4
17 16 0
9 14 0
11 7 0
17 13 0

6 10 0
12 18 0
13 14 0
15 6 0
