width 20
height 20
@@@@@@@@@@@@@@.@....
@@@@@@@@@@@@@....@@@
@@@@@@@@@@@@@@@@....
..@@@@@@@@@@@....@@@
.@@@@@@@@@@@@@@@....
..@@@@.@@@@@@@@..@@@
.@.@......@@@@@@....
.....@.@.@@@@@@.@.@.
.@@.@@.@.@@@@@@...@@
.@..@...@@@@@@@.@.@@
@@@@.@.@@@@@@@@..@@@
@@@....@@@@@@@.@.@@@
@@.@.@@.@.@@@.......
...........@@@.@.@.@
.@@@@.@@@.@@@...@@.@
@@@@@@.@@..@@.@@@...
@@@@@@....@@...@@@@.
@@@@@@.@@@@.@.@@@...
@@@@@@........@@@@@@
@@@@...@@.@.@.@@@@@@
4
15 9 0
16 12 0
15 7 0
9 19 0

9 18 0
0 13 0
9 13 0
17 8 0
