width 20
height 20
@@@@@@@@...@@@@@@@@@
@@@@@@@@.@@@@@@@@@@@
.@@@@@@..@.@@@@@@@@@
.@@@@@@@.@..@@@..@@@
..@.@@@@.@.@.@.@.@@@
.@@..@.@.........@@@
....@....@.@@.@.@.@@
@@.@.@.@..@@...@@...
.......@.@@@@.@.@.@@
@@.@@.@..@@@@@@.@...
...@.@.@@@@.@.@...@.
@@.....@.@......@@@.
@@@@.@...@.@@.@....@
@@@@@@@@....@@.@.@.@
@@@@@@@..@.@...@..@@
@@@@@@@@..@@@@...@@@
@@@@@@...@@@@..@@@@@
@@@@...@@@.@.@...@@@
@@@@@@.......@@.@@@@
@@@@@@.@.@@.@@@@@@@@
4
7 16 0
13 8 0
8 5 0
10 5 0

9 5 0
15 11 0
8 14 0
9 15 0
