width 20
height 20
@@@@.....@@@@@@@@@@@
@@@.@.@.@@@@@@@@@@@@
@@....@@@@@@@@@@@@@@
@.@.@@.@.@@@@@@@@@@@
....@@.@..@@@@@@@@@@
.@.@...@.@@@@@@@@@@@
..@..@....@@@@@@@@@@
.@.@.@.@.@@@@@@@@@@@
.....@..@@@@@@.@@@@@
.@.@.@@@@@@@@@..@@@@
@@@...@.@@@@.@.@@@@@
@@..@@....@@.......@
@@@....@.@.@.@.@.@@@
@@.@.@@.......@@@@@@
.@...@.@@.@@@@@@@@@@
...@....@@@@@@@@@@@@
.@..@@@.@@@@@@@@@@@@
..@..@.@@@@@@@@@@@@@
.@@.@..@@@@@@@@@@@@@
..@...@@@@@@@@@@@@@@
11
7 1 0
6 5 0
2 5 0
0 18 0
5 18 1
4 2 1
9 11 1
12 13 1
0 4 2
18 11 2
0 15 2

6 7 0
9 11 0
0 7 0
3 1 0
4 8 1
2 5 1
3 4 1
2 2 1
2 4 2
5 1 2
8 4 2
