width 20
height 20
@@@@@@@@@@@@@@@@@@@@
@@@@@@@@@@@@@@@@@@@@
@@@@@@@@@@@@@@@@@@@@
@@@@@@@@@@@@@@@@@@@@
@@@@@@@@@@@@@@@@@@@@
@@@@@@@@@@@@@@@@@@@@
@@@@@@@@@@@@@@@@@@@@
@@@@@@@@.@@@@@@@@@@@
@@@@@@.@.@@@@@@@@@@@
@@@@......@@@@@@@@@@
@@@.@@.@.@.@@@@@@@@@
@@@.....@...@@@@@@@@
@@@.@.@.@.@@..@@@@@@
@@@@.@......@..@@@@@
@@@....@@.@...@@@@@@
@@.@.@.@@..@@@@@@@@@
@@...@@.@.@.@..@@@@@
@@.@.@@.@.....@.@@@@
@...@@....@.@....@@@
@@.@@@@.@.@.@.@.@@@@
11
3 14 0
14 13 0
7 18 0
11 14 0
10 10 1
3 16 1
4 15 1
13 18 1
7 11 2
3 18 2
8 18 2

2 19 0
11 11 0
13 18 0
1 18 0
10 10 1
4 14 1
11 13 1
3 11 1
7 11 2
8 8 2
2 18 2
