width 20
height 20
..@@@.@@@@@@@@@@@@@@
@.....@@@@@@@@@@@@@@
@.@@.@@@@..@@@@@@@@@
....@@@@.@.@@@@@@@@@
@.@..@...@..@@@@@@@@
...@.@.@...@...@@..@
@.@.@.@.@.@.@.@...@@
............@.@.@...
@.@@.@.@@.@....@..@@
..@.@@@@@@..@.@..@@.
@.....@....@....@.@.
..@.@@..@@..@@.@@...
.@@..@.@@@.@...@..@.
..@@@..@@@@@.@@.@..@
.@.@.@@.@@.@@.....@@
..............@@.@@@
.@@@@@@.@.@.@.@.@@@@
..@@@@@@@@@@....@@@@
.@@@@@@@@@@@@.@@@@@@
..@@@@@@@@@@@@@@@@@@
11
1 15 0
14 12 0
9 6 0
13 16 0
13 15 1
5 0 1
13 10 1
15 10 1
17 5 2
16 15 2
11 15 2

13 12 0
9 16 0
19 11 0
2 14 0
17 5 1
2 3 1
15 6 1
15 13 1
7 16 2
16 15 2
0 19 2
