width 20
height 20
@.@.@.@@@@@@@@@@@@@@
....@..@@@@@@@@@@@@@
@.@...@@@@@@@@@@@@@@
@@@.@..@.@@@@@@@@@@@
@@..@@....@@@@@@@@@@
@@@..@@@@..@@@@@@@@@
@@..@@@@@.@@@@@@@@@@
@@@.@@@@@.@@@@@@@@@@
@@...@.@.@@@@@@@@@@@
@@@.@@...@@@@@@@@@@@
@@@.@.@.@.@@@@@@@@@@
@@..@......@@@@@@@@@
.@@...@.@.@@@@@@@@@@
.@.@.@@..@@@@@@@@@@@
.....@..@@@@@@@@@@@@
.@.@.@@@@@@@@@@@@@@@
.@@.@.@.@@@@@@@@@@@@
.........@@@@@@@@@@@
@@@@.@@.@@@@@@@@@@@@
.......@@@@@@@@@@@@@
11
2 13 0
3 2 0
0 16 0
6 17 0
8 17 1
1 14 1
2 19 1
3 10 1
2 1 2
9 10 2
0 14 2

3 19 0
7 10 0
6 3 0
1 2 0
3 12 1
1 14 1
4 12 1
3 5 1
5 19 2
4 13 2
3 17 2
