width 20
height 20
@@@@@@@@@@@@@.@@@@@@
@@@@@@@@@@@@...@@@@@
@@@@@@@@@@@@@.@.@@@@
@@@@@@@@@@@@@...@@@@
@@@@@@@@@@.@.@@.@@@@
@@@@@@@@@........@@@
@@@@@@@@@.@.@@@.@@@@
@@@@@@@@...@.@.@@@@@
@@@@@@@.@@...@.@.@.@
@@@@@@..@@.@........
@..@@..@....@.@@.@@@
..@...@..@.@@@@.....
.@.@@.@.@.@@@@@@.@@.
...........@@@@@.@@@
.@.@@@@.@.@@@@@....@
.@....@.@.@@@@@@@.@@
.@.@.@@..@.@@@@@@@@@
.@@@...@....@@@@@@@@
.@@..@.@@.@..@@@@@@@
@...@...@@..@@@@@@@@
11
15 2 0
14 9 0
15 14 0
18 11 0
17 14 1
1 19 1
5 13 1
2 19 1
12 9 2
11 17 2
2 13 2

6 18 0
7 13 0
14 5 0
12 4 0
8 10 1
4 11 1
2 14 1
8 17 1
10 7 2
11 17 2
11 8 2
