width 20
height 20
@@@@@@@@@@@@@@@@@@@@
@@@@@.@@@@@@@@@@@@@@
@@@@@.@@@@@@@@@@@@@@
@@@@....@@@@@@@@@@@@
@@@@.@.@..@@@@@@@@@@
@@@...@..@@@@@@@@@@@
@@@@@...@@@@@@@@@@@@
@@@@@@@..@@@@@@@@@@@
@@@@@...@@@@@@@@@@@@
@@@@..@...@@@@@@@@@@
@@@@@@..@..@@@@@@@@@
@@@@@@@..@@..@@@@@@@
@@@@@@@.@..@.@@@@@@@
@@@@@@@...@...@@@@@@
@@@@@@@@@.@.@...@@@@
@@@@@@@@....@@.@@@@@
@@@@@@@@@@.@..@@@@@@
@@@@@@@@@@..@.@@@@@@
@@@@@@@@@@@...@@@@@@
@@@@@@@@@@@.@@@@@@@@
11
11 14 0
11 19 0
13 16 0
8 13 0
4 5 1
5 1 1
6 3 1
6 8 1
9 9 2
8 7 2
9 4 2

13 18 0
6 10 0
9 10 0
14 14 0
7 10 1
5 2 1
10 12 1
5 3 1
9 9 2
13 16 2
8 9 2
