width 20
height 20
@@@@@@@@@@@@@@..@..@
@@@@..@@@@@@@.@.@@..
.@@@.@@@.@.@@...@.@.
..@@..@.......@.....
.@.@.@@.@.@@@.@.@@.@
.........@.@...@@..@
.@@.@@@@@@.@.@..@@..
@@..@.@....@@@.@@@@.
@@@...@.@@..@....@..
@@@@@@@@.@.@.@.@@@@.
@@@@@@@.........@@@@
@@@@@@@@.@.@.@.@@@@@
@.@@@@@@..@...@@@@@@
....@.@.@.@.@...@@@@
@@@......@@..@.@@@@@
@@@@@.@@..@.@@@@@@@@
@@@@@@@@@.....@@@@@@
@@@@@@@@..@@.@@@@@@@
@@@@@@@@@@@@@@@@@@@@
@@@@@@@@@@@@@@@@@@@@
7
2 7 0
4 4 0
11 14 0
12 9 0
11 15 0
16 3 0
7 10 0

12 9 0
12 6 0
5 13 0
14 0 0
15 10 0
7 14 0
15 6 0
