width 20
height 20
....@@@.............
....@@....@.........
....@@....@.........
................@...
.....@....@..@......
@...................
..@.@........@......
.........@..@.......
...@..........@.....
......@.............
@...@...@..@........
..@...@..@...@..@...
.@..@.....@.........
.........@..@..@....
...@.........@......
........@......@....
............@...@...
........@...........
....@@..............
....................
4
11 16 0
11 19 0
19 14 0
5 7 0

11 15 0
2 14 0
9 12 0
5 7 0
