width 20
height 20
@........@@@........
@.....@..@@@.....@..
@...@.........@....@
...@...............@
.............@......
.................@..
........@...@.....@.
.....@..............
....@...........@...
...@@..@..@.........
....@@.....@........
....................
....................
.........@....@..@..
......@...@.........
...@........@..@.@..
.....@...@..........
.@@@........@...@...
..@@................
..@@@..........@@@..
4
1 7 0
16 2 0
18 3 0
9 6 0

19 18 0
0 10 0
6 17 0
2 3 0
