width 20
height 20
@@@@@...............
.@@.................
...............@..@.
....@...............
......@...@.........
................@...
@...................
@...@.@.....@.....@.
.........@........@.
......@.........@...
.....@...........@..
..@.......@.@.......
....................
........@....@.@..@.
......@..@..........
................@...
......@.............
.......@............
.....@..@......@...@
...................@
5
17 18 0
18 17 0
12 3 1
5 1 1
13 16 2

15 16 0
18 17 0
0 12 1
14 16 1
15 9 2
