width 20
height 20
....................
...........@...@....
@..@................
@....@..............
....@..........@....
.......@.@..........
...................@
.......@...........@
..........@.....@.@.
.............@......
........@.....@.....
....@.....@.........
....................
...............@....
.........@..........
...@................
...@.......@........
.....@.......@.@....
....................
...........@........
5
4 15 0
8 9 0
17 8 1
18 2 1
18 6 2

15 2 0
19 18 0
15 7 1
4 16 1
5 16 2
