width 20
height 20
@@@@@@@@@@.....@.@@@
@@@@@@@@...@.@....@@
@@@@@@@@@@.@@.@.@.@@
@@@@@@@@@@@......@@@
.@@.@@@@.@.@@.@@.@@@
............@...@@.@
.@.@.@@.@.@@@@.@@@.@
@...@@@@@@@@@@..@..@
.@.@@@...@@@.@.@@@..
....@@.@@.@.....@..@
.@.@........@.@..@..
@..@@.@@.@.@.@.@.@.@
.@....@@..@@.@......
...@@.@.@@.....@.@@@
.@..@@@....@.@.@..@@
..@.@..@@.@...@.@@@@
.@.@.@.@@@@@.@..@@@@
........@@@....@@@@@
.@@@.@.@@@@@.@..@@@@
.@@@.@..@@@@@@.@@@@@
5
4 18 0
17 1 0
5 5 1
10 11 1
6 15 2

7 5 0
6 9 0
4 5 1
18 6 1
8 1 2
