width 20
height 20
....@@@@@.@..@..@@@@
@.@..@@@..@.@@@..@@@
..@.@@@.@.@.@.@.@@@@
@.@..@......@.@.@.@@
...@...@.@@.....@..@
@.@..@@..@..@@@.@.@.
@@@.@...@@@@....@...
@.@..@@@.@.@@.@.@.@@
..@.@@@.......@.....
@....@..@.@.@.@@@.@.
@.@.@@@..@@..@@@.@@.
...@@@@@.@..@@@....@
@.@.@.@.@.@@.@.@.@@.
....................
@.@.@.@.@@.@.@.@@.@.
@.@@@@@@@@@@@...@..@
.....@@@@@@@@@.@@@..
@.@.@@@@@@@@@@@@@@@.
@@..@@@@@@@@@@@@@@@.
@..@@@@@@@@@@@@@@@@@
5
12 12 0
1 2 0
14 4 1
13 6 1
6 4 2

15 11 0
11 0 0
13 6 1
2 19 1
15 5 2
