width 20
height 20
....................
.............@.@..@.
......@.@.@.@...@...
....................
...............@....
....@......@....@...
.@.......@.@........
.................@..
.......@......@.@...
.@.@.@..............
.@........@.........
.......@.........@..
.@.......@.@...@....
....@............@..
.........@..........
.......@...........@
.@.........@........
......@...@.........
..@.................
................@...
1
3 5 0

8 9 0
