width 20
height 20
...................@
....@........@.@....
@.@...............@.
.......@............
....@......@........
....................
...............@....
..@...@.@.@.@.......
.@..@..@............
..............@.....
..@.....@...@.......
.......@@......@....
...@.....@..........
....................
.@...@.......@...@..
@......@.@.@........
.......@............
...@.@.....@.@......
..........@.........
...................@
6
13 9 0
12 11 0
1 9 0
0 19 0
17 15 0
16 0 0

7 2 0
5 0 0
0 3 0
11 9 0
11 19 0
0 17 0
