width 20
height 20
@..@@@..............
....................
.@............@.@...
..@.................
....@...@......@....
@...................
@...........@.......
..@...@.............
..@.................
.............@......
............@.......
...............@....
..@......@..........
............@....@..
....@..@..@.........
....................
....................
@..@........@.......
@......@......@.@...
@..........@........
6
8 3 0
10 16 0
12 5 0
15 16 0
1 0 0
15 8 0

4 18 0
1 6 0
17 17 0
14 7 0
6 14 0
9 5 0
