width 20
height 20
...................@
...............@....
......@..@.@........
....@......@........
.............@..@...
...@....@...........
.........@..........
....................
...@.......@........
....@..@.......@....
....................
....@.@..@..........
.......@....@.......
....................
...........@........
.@......@...........
....@.....@.....@...
......@..........@.@
...................@
@..................@
6
10 10 0
3 4 0
6 5 0
17 5 0
17 7 0
10 4 0

12 10 0
19 13 0
6 8 0
2 16 0
3 3 0
19 14 0
