width 20
height 20
@@.@...@.@.@.....@@@
@....@@....@.@@.@@@@
.@@@.@.@.@@..@..@@@@
............@.@..@@@
.@@.@.@@.@@@....@@@@
@..@@@@@@..@@.@.@@@@
@.@.@.@@@.@.@..@@@@@
..............@@@@@@
@.@@.@@.@.@.@.@@@@@@
....@@@.@..@.@@@@@@@
@.@..@@@..@..@@@@@@@
@@..@.@.@@.@..@@@@@@
@@@..........@.@@@@@
@@@@@@.@@@.@@@..@@@@
@@@@@@@.....@..@@@@@
@@@@@@@@.@.@.@.@@@@@
@@@@@....@.@....@@@@
@@@@@@.@..@..@.@@@@@
@@@@@@@..@.@..@@@@@@
@@@@@@@@.....@@@@@@@
4
4 12 0
5 6 0
7 3 1
8 15 2

6 0 0
8 19 0
11 10 1
13 4 2
